token	lemma	pos	Gend
at	at	CONcoo	_
cum	cum	CONsub	_
tonantis	tono	VER	Com
annus	annus	NOM	_
hibernus	hibernus	ADJqua	Masc
Iouis	iuppiter	NOM	_
imbris	imber	NOM	_
niuis	nix	NOM	_
-que	que	CONcoo	_
conparat	comparo	VER	_
aut	aut	CONcoo	_
trudit	trudo	VER	_
acris	acer	ADJqua	MascFem
hinc	hinc	ADV	_
et	et	CONcoo	_
hinc	hinc	ADV	_
multa	multus	ADJqua	Fem
cane	canis	NOM	_
apros	aper	NOM	_
in	in	PRE	_
obstantis	obsto	VER	MascFem
plagas	plaga	NOM	_
aut	aut	CONcoo	_
amite	ames	NOM	_
leui	leuis	ADJqua	Com
rara	rarus	ADJqua	Neut
tendit	tendo	VER	_
retia	rete	NOM	_
turdis	turdus	NOM	_
edacibus	edax	ADJqua	Com
dolos	dolus	NOM	_
pauidum	pauidus	ADJqua	MascNeut
-que	que	CONcoo	_
leporem	lepor	NOM	_
et	et	CONcoo	_
aduenam	aduena	NOM	_
laqueo	laqueus	NOM	_
gruem	grus	NOM	_
iucunda	iucundus	ADJqua	Neut
captat	capto	VER	_
praemia	praemium	NOM	_

quin	quin	CONsub	_
huc	huc	ADV	_
inanis	inanis	ADJqua	MascFem
si	si	CONsub	_
potes	possum	VER	_
uertis	uerto	VER	_
minas	minae	NOM	_
et	et	CONcoo	_
me	ego	PROper	_
remorsurum	remordeo	VER	MascNeut
petis	peto	VER	_

muricibus	murex	NOM	_
Tyriis	tyrius	ADJqua	Com
iteratae	itero	VER	Fem
uellera	uellus	NOM	_
lanae	lana	NOM	_
cui	quis	PROint	Com
properabantur	propero	VER	_

has	hic	PROdem	Fem
inter	inter	PRE	_
epulas	epulae	NOM	_
ut	ut	ADVint	_
iuuat	iuuo	VER	_
pastas	pascor	VER	Fem
ouis	ouis	NOM	_
uidere	uideo	VER	_
properantis	propero	VER	MascFem
domum	domus	NOM	_
uidere	uideo	VER	_
fessos	fessus	ADJqua	Masc
uomerem	uomer	NOM	_
inuersum	inuerto	VER	MascNeut
boues	bos	NOM	_
collo	collum	NOM	_
trahentis	traho	VER	MascFem
languido	languidus	ADJqua	MascNeut
positos	pono	VER	Masc
-que	que	CONcoo	_
uernas	uerna	NOM	_
ditis	diues	ADJqua	Com
examen	examen	NOM	_
domus	domus	NOM	_
circum	circum	PRE	_
renidentis	renideo	VER	MascFem
Lares	lar	NOM	_

uoles	uolo	VER	_
modo	modo	ADV	_
altis	altus	ADJqua	Com
desilire	desilio	VER	_
turribus	turris	NOM	_
modo	modo	ADV	_
ense	ensis	NOM	_
pectus	pectus	NOM	_
Norico	noricus	ADJqua	MascNeut
recludere	recludo	VER	_
frustra	frustra	ADV	_
-que	que	CONcoo	_
uincla	uinculum	NOM	_
gutturi	guttur	NOM	_
nectes	necto	VER	_
tuo	tuus	PROpos	MascNeut
fastidiosa	fastidiosus	ADJqua	Fem
tristis	tristis	ADJqua	MascFem
aegrimonia	aegrimonia	NOM	_

roges	rogo	VER	_
tuum	tuus	PROpos	MascNeut
labore	labor	NOM	_
quid	quis	PROint	Neut
iuuem	iuuo	VER	_
meo	meum	NOM	_
inbellis	imbellis	ADJqua	MascFem
ac	ac	CONcoo	_
firmus	firmus	ADJqua	Masc
parum	parum	ADV	_

quod	quod	CONcoo	_
si	si	CONsub	_
meis	meus	PROpos	Com
inaestuet	inaestuo	VER	_
praecordiis	praecordia	NOM	_
libera	liber	ADJqua	Fem
bilis	bilis	NOM	_
ut	ut	CONsub	_
haec	hic	PROdem	Neut
ingrata	ingratus	ADJqua	Neut
uentis	uentus	NOM	_
diuidat	diuido	VER	_
fomenta	fomentum	NOM	_
uolnus	uulnus	NOM	_
nil	nihil	PROind	_
malum	malus	ADJqua	MascNeut
leuantia	leuo	VER	Neut
desinet	desino	VER	_
inparibus	impar	ADJqua	Com
certare	certo	VER	_
summotus	submoueo	VER	Masc
pudor	pudor	NOM	_

furor	furor	NOM	_
-ne	ne	ADVint	_
caecus	caecus	ADJqua	Masc
an	an	ADVint	_
rapit	rapio	VER	_
uis	uis	NOM	_
acrior	acer	ADJqua	MascFem
an	an	ADVint	_
culpa	culpa	NOM	_

iamiam	iamiam	ADV	_
efficaci	efficax	ADJqua	Com
do	do	VER	_
manus	manus	NOM	_
scientiae	scientia	NOM	_
supplex	supplex	NOM	_
et	et	CONcoo	_
oro	oro	VER	_
regna	regnum	NOM	_
per	per	PRE	_
Proserpinae	proserpina	NOM	_
per	per	PRE	_
et	et	CONcoo	_
Dianae	diana	NOM	_
non	non	ADVneg	_
mouenda	moueo	VER	Neut
numina	numen	NOM	_
per	per	PRE	_
atque	atque	CONcoo	_
libros	liber	NOM	_
carminum	carmen	NOM	_
ualentium	ualeo	VER	Com
refixa	refigo	VER	Neut
caelo	caelum	NOM	_
deuocare	deuoco	VER	_
sidera	sidus	NOM	_
Canidia	canidia	NOM	_
parce	parco	VER	_
uocibus	uox	NOM	_
tandem	tandem	ADV	_
sacris	sacer	ADJqua	Com
citum	cieo	VER	MascNeut
-que	que	CONcoo	_
retro	retro	ADV	_
solue	soluo	VER	_
solue	soluo	VER	_
turbinem	turbo	NOM	_

a	ah	INJ	_
a	ah	INJ	_
solutus	soluo	VER	Masc
ambulat	ambulo	VER	_
ueneficae	uenefica	NOM	_
scientioris	sciens	ADJqua	MascNeut
carmine	carmen	NOM	_

horrida	horridus	ADJqua	Fem
tempestas	tempestas	NOM	_
caelum	caelum	NOM	_
contraxit	contraho	VER	_
et	et	CONcoo	_
imbres	imber	NOM	_
niues	nix	NOM	_
-que	que	CONcoo	_
deducunt	deduco	VER	_
Iouem	iuppiter	NOM	_
nunc	nunc	ADV	_
mare	mare	NOM	_
nunc	nunc	ADV	_
siluae	silua	NOM	_
Threicio	threicius	ADJqua	MascNeut
Aquilone	aquilo	NOM	_
sonant	sono	VER	_

utrumne	utrumne	ADVint	_
iussi	iubeo	VER	Masc
persequemur	persequor	VER	_
otium	otium	NOM	_
non	non	ADVneg	_
dulce	dulcis	ADJqua	Neut
ni	ni	CONsub	_
te	tu	PROper	_
-cum	cum	PRE	_
simul	simul	ADV	_
an	an	ADVint	_
hunc	hic	PROdem	Masc
laborem	labor	NOM	_
mente	mens	NOM	_
laturi	fero	VER	Masc
decet	decet	VER	_
qua	qui	PROrel	Fem
ferre	fero	VER	_
non	non	ADVneg	_
mollis	mollis	ADJqua	MascFem
uiros	uir	NOM	_

quid	quis	PROint	Neut
inmerentis	immerens	ADJqua	MascFem
hospites	hospes	NOM	_
uexas	uexo	VER	_
canis	canis	NOM	_
ignauus	ignauus	NOM	_
aduersum	aduersus	PRE	_
lupos	lupus	NOM	_

illic	illic	ADV	_
iniussae	iniussus	ADJqua	Fem
ueniunt	uenio	VER	_
ad	ad	PRE	_
mulctra	mulctrum	NOM	_
capellae	capella	NOM	_
refert	refert	VER	_
-que	que	CONcoo	_
tenta	tendo	VER	Neut
grex	grex	NOM	_
amicus	amicus	ADJqua	Masc
ubera	uber	NOM	_
nec	nec	CONcoo	_
uespertinus	uespertinus	ADJqua	Masc
circumgemit	circumgemo	VER	_
ursus	ursus	NOM	_
ouile	ouile	NOM	_
nec	nec	CONcoo	_
intumescit	intumesco	VER	_
alta	altus	ADJqua	Fem
uiperis	uipera	NOM	_
humus	humus	NOM	_
nulla	nullus	PROind	Neut
nocent	noceo	VER	_
pecori	pecus	NOM	_
contagia	contagium	NOM	_
nullius	nullus	PROind	Com
astri	astrum	NOM	_
gregem	grex	NOM	_
aestuosa	aestuosus	ADJqua	Fem
torret	torreo	VER	_
inpotentia	impotentia	NOM	_

o	o	INJ	_
quantus	quantus	PROint	Masc
instat	insto	VER	_
nauitis	nauta	NOM	_
sudor	sudor	NOM	_
tuis	tuus	PROpos	Com
tibi	tu	PROper	_
-que	que	CONcoo	_
pallor	pallor	NOM	_
luteus	luteus	ADJqua	Masc
et	et	CONcoo	_
illa	ille	PROdem	Fem
non	non	ADVneg	_
uirilis	uirilis	ADJqua	MascFem
heiulatio	eiulatio	NOM	_
preces	prex	NOM	_
et	et	CONcoo	_
auersum	auersus	ADJqua	MascNeut
ad	ad	PRE	_
Iouem	iuppiter	NOM	_
Ionius	ionius	ADJqua	Masc
udo	udus	ADJqua	MascNeut
cum	cum	CONsub	_
remugiens	remugio	VER	Com
sinus	sinus	NOM	_
noto	notus	NOM	_
carinam	carina	NOM	_
ruperit	rumpo	VER	_

optat	opto	VER	_
quietem	quies	NOM	_
Pelopis	pelops	NOM	_
infidi	infidus	ADJqua	MascNeut
pater	pater	NOM	_
egens	egeo	VER	Com
benignae	benignus	ADJqua	Fem
Tantalus	tantalus	NOM	_
semper	semper	ADV	_
dapis	daps	NOM	_
optat	opto	VER	_
Prometheus	prometheus	NOM	_
obligatus	obligo	VER	Masc
aliti	ales	NOM	_
optat	opto	VER	_
supremo	superus	ADJqua	MascNeut
conlocare	colloco	VER	_
Sisyphus	sisyphus	NOM	_
in	in	PRE	_
monte	mons	NOM	_
saxum	saxum	NOM	_
sed	sed	CONcoo	_
uetant	ueto	VER	_
leges	lex	NOM	_
Iouis	iuppiter	NOM	_

at	at	CONcoo	_
si	si	CONsub	_
quid	quis	PROind	Neut
umquam	umquam	ADV	_
tale	talis	PROdem	Neut
concupiueris	concupisco	VER	_
iocose	iocosus	ADJqua	Masc
Maecenas	maecenas	NOM	_
precor	precor	VER	_
manum	manus	NOM	_
puella	puella	NOM	_
sauio	suauium	NOM	_
opponat	oppono	VER	_
tuo	tuus	PROpos	MascNeut
extrema	exter	ADJqua	Fem
et	et	CONcoo	_
in	in	PRE	_
sponda	sponda	NOM	_
cubet	cubo	VER	_

ut	ut	CONsub	_
haec	hic	PROdem	Neut
trementi	tremo	VER	Com
questus	queror	VER	Masc
ore	os	NOM	_
constitit	consisto	VER	_
insignibus	insigne	NOM	_
raptis	rapio	VER	Com
puer	puer	NOM	_
inpube	impubes	ADJqua	Neut
corpus	corpus	NOM	_
quale	qualis	PROrel	Neut
posset	possum	VER	_
inpia	impius	ADJqua	Neut
mollire	mollio	VER	_
Thracum	thraces	NOM	_
pectora	pectus	NOM	_
Canidia	canidia	NOM	_
breuibus	breuis	ADJqua	Com
inplicata	implico	VER	Fem
uiperis	uipera	NOM	_
crinis	crinis	NOM	_
et	et	CONcoo	_
incomptum	incomptus	ADJqua	MascNeut
caput	caput	NOM	_
iubet	iubeo	VER	_
sepulcris	sepulcrum	NOM	_
caprificos	caprificus	NOM	_
erutas	eruo	VER	Fem
iubet	iubeo	VER	_
cupressos	cupressus	NOM	_
funebris	funebris	ADJqua	MascFem
et	et	CONcoo	_
uncta	ungo	VER	Neut
turpis	turpis	ADJqua	Com
oua	ouum	NOM	_
ranae	rana	NOM	_
sanguine	sanguis	NOM	_
plumam	pluma	NOM	_
-que	que	CONcoo	_
nocturnae	nocturnus	ADJqua	Fem
strigis	strix	NOM	_
herbas	herba	NOM	_
-que	que	CONcoo	_
quas	qui	PROrel	Fem
Iolcos	iolcus	NOM	_
atque	atque	CONcoo	_
Hiberia	iberia	NOM	_
mittit	mitto	VER	_
uenenorum	uenenum	NOM	_
ferax	ferax	ADJqua	Com
et	et	CONcoo	_
ossa	os	NOM	_
ab	ab	PRE	_
ore	os	NOM	_
rapta	rapio	VER	Neut
ieiunae	ieiunus	ADJqua	Fem
canis	canis	NOM	_
flammis	flamma	NOM	_
aduri	aduro	VER	_
Colchicis	colchicus	ADJqua	Com

nunc	nunc	ADV	_
gloriantis	glorior	VER	Com
quamlibet	quilibet	PROind	Fem
mulierculam	muliercula	NOM	_
uincere	uinco	VER	_
mollitia	mollitia	NOM	_
amor	amor	NOM	_
lycisci	lyciscus	NOM	_
me	ego	PROper	_
tenet	teneo	VER	_
unde	unde	ADVrel	_
expedire	expedio	VER	_
non	non	ADVneg	_
amicorum	amicus	NOM	_
queant	queo	VER	_
libera	liber	ADJqua	Neut
consilia	consilium	NOM	_
nec	nec	CONcoo	_
contumeliae	contumelia	NOM	_
graues	grauis	ADJqua	MascFem
sed	sed	CONcoo	_
alius	alius	PROind	Masc
ardor	ardor	NOM	_
aut	aut	CONcoo	_
puellae	puella	NOM	_
candidae	candidus	ADJqua	Fem
aut	aut	CONcoo	_
teretis	teres	ADJqua	Com
pueri	puer	NOM	_
longam	longus	ADJqua	Fem
renodantis	renodo	VER	Com
comam	coma	NOM	_

secunda	secundus	ADJqua	Fem
ratem	ratis	NOM	_
occupare	occupo	VER	_
quid	quis	PROint	Neut
moramur	moror	VER	_
alite	ales	NOM	_

sic	sic	ADV	_
placet	placeo	VER	_

quin	quin	ADV	_
ubi	ubi	CONsub	_
perire	pereo	VER	_
iussus	iubeo	VER	Masc
exspirauero	exspiro	VER	_
nocturnus	nocturnus	ADJqua	Masc
occurram	occurro	VER	_
furor	furor	NOM	_
petam	peto	VER	_
-que	que	CONcoo	_
uoltus	uultus	NOM	_
umbra	umbra	NOM	_
curuis	curuus	ADJqua	Com
unguibus	unguis	NOM	_
quae	qui	PROrel	Fem
uis	uis	NOM	_
deorum	deus	NOM	_
est	sum	VER	_
Manium	manes	NOM	_
et	et	CONcoo	_
inquietis	inquietus	ADJqua	Com
adsidens	assideo	VER	Com
praecordiis	praecordia	NOM	_
pauore	pauor	NOM	_
somnos	somnus	NOM	_
auferam	aufero	VER	_

infamis	infamis	ADJqua	Com
Helenae	helena	NOM	_
Castor	castor	NOM	_
offensus	offendo	VER	Masc
uice	uicis	NOM	_
frater	frater	NOM	_
-que	que	CONcoo	_
magni	magnus	ADJqua	MascNeut
Castoris	castor	NOM	_
uicti	uinco	VER	Masc
prece	prex	NOM	_
adempta	ademo	VER	Neut
uati	uates	NOM	_
reddidere	reddo	VER	_
lumina	lumen	NOM	_
et	et	ADV	_
tu	tu	PROper	_
potes	possum	VER	_
nam	nam	CONcoo	_
solue	soluo	VER	_
me	ego	PROper	_
dementia	dementia	NOM	_
o	o	INJ	_
nec	nec	CONcoo	_
paternis	paternus	ADJqua	Com
obsoleta	obsolesco	VER	Fem
sordibus	sordes	NOM	_
neque	neque	CONcoo	_
in	in	PRE	_
sepulcris	sepulcrum	NOM	_
pauperum	pauper	ADJqua	Com
prudens	prudens	ADJqua	Com
anus	anus	NOM	_
nouendialis	niuendialis	ADJqua	MascFem
dissipare	dissipo	VER	_
pulueres	puluis	NOM	_
tibi	tu	PROper	_
hospitale	hospitalis	ADJqua	Neut
pectus	pectus	NOM	_
et	et	CONcoo	_
purae	purus	ADJqua	Fem
manus	manus	NOM	_
tuus	tuus	PROpos	Masc
-que	que	CONcoo	_
uenter	uenter	NOM	_
Pactumeius	pactumeus	NOM	_
et	et	CONcoo	_
tuo	tuus	PROpos	MascNeut
cruore	cruor	NOM	_
rubros	ruber	ADJqua	Masc
obstetrix	obstetrix	NOM	_
pannos	pannus	NOM	_
lauit	lauo	VER	_
utcumque	utcumque	ADVrel	_
fortis	fortis	ADJqua	MascFem
exsilis	exsilio	VER	_
puerpera	puerpera	NOM	_

rapiamus	rapio	VER	_
amici	amicus	NOM	_
occasionem	occasio	NOM	_
de	de	PRE	_
die	dies	NOM	_
dum	dum	CONsub	_
-que	que	CONcoo	_
uirent	uireo	VER	_
genua	genu	NOM	_
et	et	CONcoo	_
decet	decet	VER	_
obducta	obduco	VER	Fem
soluatur	soluo	VER	_
fronte	frons	NOM	_
senectus	senectus	NOM	_

diris	dirae	NOM	_
agam	ago	VER	_
uos	uos	PROper	_
dira	dirus	ADJqua	Fem
detestatio	detestatio	NOM	_
nulla	nullus	PROind	Fem
expiatur	expio	VER	_
uictima	uictima	NOM	_

quid	quis	PROint	Neut
amplius	amplus	ADJqua	Neut
uis	uolo	VER	_

ut	ut	CONsub	_
horridis	horridus	ADJqua	Com
utrumque	uterque	PROind	MascNeut
uerberes	uerbero	VER	_
latus	latus	NOM	_
Auster	auster	NOM	_
memento	memini	VER	_
fluctibus	fluctus	NOM	_
niger	niger	ADJqua	Masc
rudentis	rudens	NOM	_
Eurus	eurus	NOM	_
inuerso	inuerto	VER	MascNeut
mari	mare	NOM	_
fractos	fractus	ADJqua	Masc
-que	que	CONcoo	_
remos	remus	NOM	_
differat	differo	VER	_
insurgat	insurgo	VER	_
Aquilo	aquilo	NOM	_
quantus	quantus	PROrel	Masc
altis	alo	VER	Com
montibus	mons	NOM	_
frangit	frango	VER	_
trementis	tremo	VER	Com
ilices	ilex	NOM	_
nec	nec	CONcoo	_
sidus	sidus	NOM	_
atra	ater	ADJqua	Fem
nocte	nox	NOM	_
amicum	amicus	ADJqua	Neut
adpareat	appareo	VER	_
qua	qua	ADVrel	_
tristis	tristis	ADJqua	MascFem
Orion	orion	NOM	_
cadit	cado	VER	_
quietiore	quietus	ADJqua	Com
nec	nec	CONcoo	_
feratur	fero	VER	_
aequore	aequor	NOM	_
quam	quam	ADVrel	_
Graia	graius	ADJqua	Fem
uictorum	uictor	NOM	_
manus	manus	NOM	_
cum	cum	CONsub	_
pallas	pallas	NOM	_
usto	uro	VER	MascNeut
uertit	uerto	VER	_
iram	ira	NOM	_
ab	ab	PRE	_
Ilio	ilium	NOM	_
in	in	PRE	_
inpiam	impius	ADJqua	Fem
Aiacis	aiax	NOM	_
ratem	ratis	NOM	_

heu	heu	INJ	_
me	ego	PROper	_
per	per	PRE	_
urbem	urbs	NOM	_
nam	nam	CONcoo	_
pudet	pudeo	VER	_
tanti	tantus	PROdem	MascNeut
mali	malum	NOM	_
fabula	fabula	NOM	_
quanta	quantus	PROint	Fem
fui	sum	VER	_
conuiuiorum	conuiuium	NOM	_
et	et	ADV	_
paenitet	paeniteo	VER	_
in	in	PRE	_
quis	qui	PROrel	Com
amantem	amans	NOM	_
languor	languor	NOM	_
et	et	CONcoo	_
silentium	silentium	NOM	_
arguit	arguo	VER	_
et	et	CONcoo	_
latere	latus	NOM	_
petitus	peto	VER	Masc
imo	inferus	ADJqua	MascNeut
spiritus	spiritus	NOM	_

post	post	ADV	_
insepulta	insepultus	ADJqua	Neut
membra	membrum	NOM	_
different	differo	VER	_
lupi	lupus	NOM	_
et	et	CONcoo	_
Esquilinae	esquilinus	ADJqua	Fem
alites	ales	NOM	_
neque	neque	CONcoo	_
hoc	hic	PROdem	Neut
parentes	parens	NOM	_
heu	heu	INJ	_
mihi	ego	PROper	_
superstites	superstes	ADJqua	MascFem
effugerit	effugio	VER	_
spectaculum	spectaculum	NOM	_

ubi	ubi	CONsub	_
haec	hic	PROdem	Neut
seuerus	seuerus	ADJqua	Masc
te	tu	PROper	_
palam	palam	ADV	_
laudaueram	laudo	VER	_
iussus	iubeo	VER	Masc
abire	abeo	VER	_
domum	domus	NOM	_
ferebar	fero	VER	_
incerto	incertus	ADJqua	MascNeut
pede	pes	NOM	_
ad	ad	PRE	_
non	non	ADVneg	_
amicos	amicus	NOM	_
heu	heu	INJ	_
mihi	ego	PROper	_
postis	postis	NOM	_
et	et	CONcoo	_
heu	heu	INJ	_
limina	limen	NOM	_
dura	durus	ADJqua	Neut
quibus	qui	PROrel	Com
lumbos	lumbus	NOM	_
et	et	CONcoo	_
infregi	infringo	VER	_
latus	latus	NOM	_

tibi	tu	PROper	_
nempe	nempe	ADV	_
ne	ne	CONsub	_
interforet	intersum	VER	_
aequalis	aequalis	ADJqua	MascFem
conuiua	conuiua	NOM	_
magis	magis	ADV	_
quem	qui	PROrel	Masc
diligeret	diligo	VER	_
mulier	mulier	NOM	_
sua	suus	PROpos.ref	Fem
quam	quam	ADVrel	_
te	tu	PROper	_

formidulosis	formidolosus	ADJqua	Com
dum	dum	CONsub	_
latent	lateo	VER	_
siluis	silua	NOM	_
ferae	fera	NOM	_
dulci	dulcis	ADJqua	Com
sopore	sopor	NOM	_
languidae	languidus	ADJqua	Fem
senem	senex	NOM	_
quod	qui	PROrel	Neut
omnes	omnis	PROind	MascFem
rideant	rideo	VER	_
adulterum	adulter	ADJqua	MascNeut
latrent	latro	VER	_
Suburanae	suburanus	ADJqua	Fem
canes	canis	NOM	_
nardo	nardus	NOM	_
perunctum	perungo	VER	MascNeut
quale	qualis	PROrel	Neut
non	non	ADVneg	_
perfectius	perfecte	ADV	_
meae	meus	PROpos	Fem
laborarint	laboro	VER	_
manus	manus	NOM	_

inultus	inultus	ADJqua	Masc
ut	ut	ADVint	_
tu	tu	PROper	_
riseris	rideo	VER	_
cotytia	cotytia	NOM	_
uolgata	uulgo	VER	Neut
sacrum	sacrum	NOM	_
liberi	liber	ADJqua	MascNeut
Cupidinis	cupido	NOM	_
et	et	CONcoo	_
Esquilini	esquilinus	ADJqua	MascNeut
pontifex	pontifex	NOM	_
uenefici	ueneficus	NOM	_
inpune	impune	ADV	_
ut	ut	ADVint	_
urbem	urbs	NOM	_
nomine	nomen	NOM	_
inpleris	impleo	VER	_
meo	meus	PROpos	MascNeut

ergo	ergo	CONcoo	_
aut	aut	CONcoo	_
adulta	adultus	ADJqua	Fem
uitium	uitis	NOM	_
propagine	propago	NOM	_
altas	altus	ADJqua	Fem
maritat	marito	VER	_
populos	populus	NOM	_
aut	aut	CONcoo	_
in	in	PRE	_
reducta	reductus	ADJqua	Fem
ualle	uallis	NOM	_
mugientium	mugio	VER	Com
prospectat	prospecto	VER	_
errantis	erro	VER	MascFem
greges	grex	NOM	_
inutilis	inutilis	ADJqua	MascFem
-que	que	CONcoo	_
falce	falx	NOM	_
ramos	ramus	NOM	_
amputans	amputo	VER	Com
feliciores	felix	ADJqua	MascFem
inserit	insero	VER	_
aut	aut	CONcoo	_
pressa	premo	VER	Fem
puris	purus	ADJqua	Com
mella	mel	NOM	_
condit	condo	VER	_
amphoris	amphora	NOM	_
aut	aut	CONcoo	_
tondet	tondeo	VER	_
infirmas	infirmus	ADJqua	Fem
ouis	ouis	NOM	_

haec	hic	PROdem	Neut
et	et	CONcoo	_
quae	qui	PROrel	Neut
poterunt	possum	VER	_
reditus	reditus	NOM	_
abscindere	abscindo	VER	_
dulcis	dulcis	ADJqua	MascFem
eamus	eo	VER	_
omnis	omnis	PROind	MascFem
exsecrata	exsecror	VER	Fem
ciuitas	ciuitas	NOM	_
aut	aut	CONcoo	_
pars	pars	NOM	_
indocili	indocilis	ADJqua	Com
melior	bonus	ADJqua	MascFem
grege	grex	NOM	_
mollis	mollis	ADJqua	MascFem
et	et	CONcoo	_
exspes	exspes	ADJqua	Com
inominata	inominatus	ADJqua	Neut
perpremat	perprimo	VER	_
cubilia	cubile	NOM	_

atqui	atqui	CONcoo	_
nec	nec	CONcoo	_
herba	herba	NOM	_
nec	nec	CONcoo	_
latens	latens	ADJqua	Com
in	in	PRE	_
asperis	asper	ADJqua	Com
radix	radix	NOM	_
fefellit	fallo	VER	_
me	ego	PROper	_
locis	locus	NOM	_
indormit	indormio	VER	_
unctis	ungo	VER	Com
omnium	omnis	PROind	Com
cubilibus	cubile	NOM	_
obliuione	obliuio	NOM	_
paelicum	pellex	NOM	_

quid	quis	PROint	Neut
accidit	accido	VER	_

cur	cur	ADVint	_
dira	dirus	ADJqua	Neut
barbarae	barbarus	ADJqua	Fem
minus	parum	ADV	_
uenena	uenenum	NOM	_
Medeae	medea	NOM	_
ualent	ualeo	VER	_
quibus	qui	PROrel	Com
superbam	superbus	ADJqua	Fem
fugit	fugio	VER	_
ulta	ulciscor	VER	Fem
paelicem	pellex	NOM	_
magni	magnus	ADJqua	MascNeut
Creontis	creon	NOM	_
filiam	filia	NOM	_
cum	cum	CONsub	_
palla	palla	NOM	_
tabo	tabum	NOM	_
munus	munus	NOM	_
inbutum	imbuo	VER	Neut
nouam	nouus	ADJqua	Fem
incendio	incendium	NOM	_
nuptam	nupta	NOM	_
abstulit	aufero	VER	_

feremus	fero	VER	_
et	et	CONcoo	_
te	tu	PROper	_
uel	uel	CONcoo	_
per	per	PRE	_
Alpium	alpes	NOM	_
iuga	iugum	NOM	_
inhospitalem	inhospitalis	ADJqua	MascFem
et	et	CONcoo	_
Caucasum	caucasus	NOM	_
uel	uel	CONcoo	_
occidentis	occidens	NOM	_
usque	usque	ADV	_
ad	ad	PRE	_
ultimum	ultimus	ADJqua	MascNeut
sinum	sinus	NOM	_
forti	fortis	ADJqua	Com
sequemur	sequor	VER	_
pectore	pectus	NOM	_

libenter	libenter	ADV	_
hoc	hic	PROdem	Neut
et	et	CONcoo	_
omne	omnis	PROind	Neut
militabitur	milito	VER	_
bellum	bellus	ADJqua	Neut
in	in	PRE	_
tuae	tuus	PROpos	Fem
spem	spes	NOM	_
gratiae	gratia	NOM	_
non	non	ADVneg	_
ut	ut	CONsub	_
iuuencis	iuuencus	NOM	_
inligata	illigo	VER	Neut
pluribus	multus	ADJqua	Com
aratra	aratrum	NOM	_
nitantur	nitor	VER	_
meis	meus	PROpos	Com
pecus	pecus	NOM	_
-ue	ue	CONcoo	_
Calabris	calaber	ADJqua	Com
ante	ante	PRE	_
sidus	sidus	NOM	_
feruidum	feruidus	ADJqua	MascNeut
Lucana	lucanus	ADJqua	Neut
mutet	muto	VER	_
pascuis	pascuum	NOM	_
neque	neque	CONcoo	_
ut	ut	CONsub	_
superni	supernus	ADJqua	MascNeut
uilla	uilla	NOM	_
candens	candeo	VER	Com
Tusculi	tusculum	NOM	_
Circaea	circaeus	ADJqua	Neut
tangat	tango	VER	_
moenia	moenia	NOM	_

uos	uos	PROper	_
quibus	qui	PROrel	Com
est	sum	VER	_
uirtus	uirtus	NOM	_
muliebrem	muliebris	ADJqua	MascFem
tollite	tollo	VER	_
luctum	luctus	NOM	_
Etrusca	etruscus	ADJqua	Neut
praeter	praeter	PRE	_
et	et	CONcoo	_
uolate	uolo	VER	_
litora	litus	NOM	_

opima	opimus	ADJqua	Fem
quod	quod	CONcoo	_
si	si	CONsub	_
praeda	praeda	NOM	_
curuo	curuus	ADJqua	MascNeut
litore	litus	NOM	_
porrecta	porrigo	VER	Fem
mergos	mereus	NOM	_
iuuerit	iuuo	VER	_
libidinosus	libidinosus	ADJqua	Masc
immolabitur	immolo	VER	_
caper	caper	NOM	_
et	et	CONcoo	_
agna	agna	NOM	_
Tempestatibus	tempestas	NOM	_

ut	ut	ADVrel	_
nuper	nuper	ADV	_
actus	ago	VER	Masc
cum	cum	CONsub	_
freto	fretum	NOM	_
Neptunius	neptunius	ADJqua	Masc
dux	dux	NOM	_
fugit	fugio	VER	_
ustis	uro	VER	Com
nauibus	nauis	NOM	_
minatus	minor	VER	Masc
urbi	urbs	NOM	_
uincla	uinculum	NOM	_
quae	qui	PROrel	Neut
detraxerat	detraho	VER	_
seruis	seruus	NOM	_
amicus	amicus	NOM	_
perfidis	perfidus	ADJqua	Com

hic	hic	ADV	_
inresectum	irresectus	ADJqua	MascNeut
saeua	saeuus	ADJqua	Fem
dente	dens	NOM	_
liuido	liuidus	ADJqua	MascNeut
Canidia	canidia	NOM	_
rodens	rodo	VER	Com
pollicem	pollex	NOM	_
quid	quis	PROint	Neut
dixit	dico	VER	_
aut	aut	CONcoo	_
quid	quis	PROint	Neut
tacuit	taceo	VER	_

mala	malus	ADJqua	Fem
soluta	soluo	VER	Fem
nauis	nauis	NOM	_
exit	exeo	VER	_
alite	ales	NOM	_
ferens	fero	VER	Com
olentem	oleo	VER	MascFem
Meuium	meuius	NOM	_

uides	uideo	VER	_
-ne	ne	ADVint	_
sacram	sacer	ADJqua	Fem
metiente	metior	VER	Com
te	tu	PROper	_
uiam	uia	NOM	_
cum	cum	PRE	_
bis	bis	ADJadv.mul	_
trium	tres	ADJcar	Com
ulnarum	ulna	NOM	_
toga	toga	NOM	_
ut	ut	CONsub	_
ora	os	NOM	_
uertat	uerto	VER	_
huc	huc	ADV	_
et	et	CONcoo	_
huc	huc	ADV	_
euntium	eo	VER	Com
liberrima	liber	ADJqua	Fem
indignatio	indignatio	NOM	_

comes	comes	NOM	_
minore	paruus	ADJqua	Com
sum	sum	VER	_
futurus	sum	VER	Masc
in	in	PRE	_
metu	metus	NOM	_
qui	qui	PROrel	Masc
maior	magnus	ADJqua	MascFem
absentis	absum	VER	Com
habet	habeo	VER	_
ut	ut	ADVrel	_
adsidens	assido	VER	Com
inplumibus	implumis	ADJqua	Com
pullis	pullus	NOM	_
auis	auis	NOM	_
serpentium	serpens	NOM	_
adlapsus	allapsus	NOM	_
timet	timeo	VER	_
magis	magis	ADV	_
relictis	relinquo	VER	Com
non	non	ADVneg	_
ut	ut	CONsub	_
adsit	assum	VER	_
auxili	auxilium	NOM	_
latura	fero	VER	Fem
plus	multum	ADV	_
praesentibus	praesum	VER	Com

Petti	pettius	NOM	_
nihil	nihil	PROind	_
me	ego	PROper	_
sicut	sicut	ADVrel	_
antea	antea	ADV	_
iuuat	iuuo	VER	_
scribere	scribo	VER	_
uersiculos	uersiculus	NOM	_
amore	amor	NOM	_
percussum	percutio	VER	MascNeut
graui	grauis	ADJqua	Com
amore	amor	NOM	_
qui	qui	PROrel	Masc
me	ego	PROper	_
praeter	praeter	PRE	_
omnis	omnis	PROind	MascFem
expetit	expeto	VER	_
mollibus	mollis	ADJqua	Com
in	in	PRE	_
pueris	puer	NOM	_
aut	aut	CONcoo	_
in	in	PRE	_
puellis	puella	NOM	_
urere	uro	VER	_

licet	licet	VER	_
superbus	superbus	ADJqua	Masc
ambules	ambulo	VER	_
pecunia	pecunia	NOM	_
fortuna	fortuna	NOM	_
non	non	ADVneg	_
mutat	muto	VER	_
genus	genus	NOM	_

o	o	INJ	_
mare	mare	NOM	_
et	et	CONcoo	_
terra	terra	NOM	_
ardeo	ardeo	VER	_
quantum	quantum	ADVrel	_
neque	neque	CONcoo	_
atro	ater	ADJqua	MascNeut
delibutus	delibuo	VER	Masc
Hercules	hercules	NOM	_
Nessi	nessus	NOM	_
cruore	cruor	NOM	_
nec	nec	CONcoo	_
Sicana	sicanus	ADJqua	Fem
feruida	feruidus	ADJqua	Fem
uirens	uireo	VER	Com
in	in	PRE	_
Aetna	aetna	NOM	_
flamma	flamma	NOM	_
tu	tu	PROper	_
donec	donec	CONsub	_
cinis	cinis	NOM	_
iniuriosis	iniurosus	ADJqua	Com
aridus	aridus	ADJqua	Masc
uentis	uentus	NOM	_
ferar	fero	VER	_
cales	caleo	VER	_
uenenis	uenenum	NOM	_
officina	officina	NOM	_
Colchicis	colchicus	ADJqua	Com

dedi	do	VER	_
satis	satis	ADV	_
super	super	ADV	_
-que	que	CONcoo	_
poenarum	poena	NOM	_
tibi	tu	PROper	_
amata	amo	VER	Fem
nautis	nauta	NOM	_
multum	multum	ADV	_
et	et	CONcoo	_
institoribus	institor	NOM	_
fugit	fugio	VER	_
iuuentas	iuuenta	NOM	_
et	et	CONcoo	_
uerecundus	uerecundus	ADJqua	Masc
color	color	NOM	_
reliquit	relinquo	VER	_
ossa	os	NOM	_
pelle	pellis	NOM	_
amicta	amicio	VER	Neut
lurida	luridus	ADJqua	Fem
tuis	tuus	PROpos	Com
capillus	capillus	NOM	_
albus	albus	ADJqua	Masc
est	sum	VER	_
odoribus	odor	NOM	_
nullum	nullus	PROind	Neut
a	ab	PRE	_
labore	labor	NOM	_
me	ego	PROper	_
reclinat	reclino	VER	_
otium	otium	NOM	_
urget	urgeo	VER	_
diem	dies	NOM	_
nox	nox	NOM	_
et	et	CONcoo	_
dies	dies	NOM	_
noctem	nox	NOM	_
neque	neque	CONcoo	_
est	sum	VER	_
leuare	leuo	VER	_
tenta	tendo	VER	Neut
spiritu	spiritus	NOM	_
praecordia	praecordia	NOM	_

quando	quando	ADVint	_
repostum	repono	VER	MascNeut
Caecubum	caecubum	NOM	_
ad	ad	PRE	_
festas	festus	ADJqua	Fem
dapes	daps	NOM	_
uictore	uictor	NOM	_
laetus	laetus	ADJqua	Masc
Caesare	caesar	NOM	_
te	tu	PROper	_
-cum	cum	PRE	_
sub	sub	PRE	_
alta	altus	ADJqua	Fem
sic	sic	ADV	_
Ioui	iuppiter	NOM	_
gratum	gratus	ADJqua	Neut
domo	domus	NOM	_
beate	beatus	ADJqua	Masc
Maecenas	maecenas	NOM	_
bibam	bibo	VER	_
sonante	sono	VER	Com
mixtum	misceo	VER	MascNeut
tibiis	tibia	NOM	_
carmen	carmen	NOM	_
lyra	lyra	NOM	_
hac	hic	PROdem	Fem
Dorium	dorius	ADJqua	MascNeut
illis	ille	PROdem	Com
barbarum	barbarus	NOM	_

pereat	pereo	VER	_
male	male	ADV	_
quae	qui	PROrel	Fem
te	tu	PROper	_
Lesbia	lesbia	NOM	_
quaerenti	quaero	VER	Com
taurum	taurus	NOM	_
monstrauit	monstro	VER	_
inertem	iners	ADJqua	MascFem
cum	cum	CONsub	_
mihi	ego	PROper	_
Cous	cous	ADJqua	Masc
adesset	assum	VER	_
Amyntas	amyntas	NOM	_
cuius	qui	PROrel	Com
in	in	PRE	_
indomito	indomitus	ADJqua	MascNeut
constantior	constans	ADJqua	MascFem
inguine	inguen	NOM	_
neruus	neruus	NOM	_
quam	quam	ADVrel	_
noua	nouus	ADJqua	Fem
collibus	collis	NOM	_
arbor	arbor	NOM	_
inhaeret	inhaereo	VER	_

non	non	ADVneg	_
saxa	saxum	NOM	_
nudis	nudus	ADJqua	Com
surdiora	surdus	ADJqua	Neut
nauitis	nauta	NOM	_
Neptunus	neptunus	NOM	_
alto	altus	ADJqua	MascNeut
tundit	tundo	VER	_
hibernus	hibernus	ADJqua	Masc
salo	salum	NOM	_

hic	hic	PROdem	Masc
tertius	tertius	ADJord	Masc
December	december	NOM	_
ex	ex	PRE	_
quo	qui	PROrel	MascNeut
destiti	desisto	VER	_
Inachia	inachia	NOM	_
furere	furo	VER	_
siluis	silua	NOM	_
honorem	honor	NOM	_
decutit	decutio	VER	_

capaciores	capax	ADJqua	MascFem
adfer	affero	VER	_
huc	huc	ADV	_
puer	puer	NOM	_
scyphos	scyphus	NOM	_
et	et	CONcoo	_
Chia	chius	ADJqua	Neut
uina	uinum	NOM	_
aut	aut	CONcoo	_
Lesbia	lesbius	ADJqua	Neut
uel	uel	CONcoo	_
quod	qui	PROrel	Neut
fluentem	fluo	VER	MascFem
nauseam	nausea	NOM	_
coerceat	coerceo	VER	_
metire	metior	VER	_
nobis	nos	PROper	_
Caecubum	caecubum	NOM	_

uel	uel	CONcoo	_
cum	cum	CONsub	_
decorum	decorus	ADJqua	MascNeut
mitibus	mitis	ADJqua	Com
pomis	pomum	NOM	_
caput	caput	NOM	_
Autumnus	autumnus	NOM	_
agris	ager	NOM	_
extulit	effero	VER	_
ut	ut	ADVint	_
gaudet	gaudeo	VER	_
insitiua	insitiuus	ADJqua	Neut
decerpens	decerpo	VER	Com
pira	pirum	NOM	_
certantem	certo	VER	MascFem
et	et	CONcoo	_
uuam	uua	NOM	_
purpurae	purpura	NOM	_
qua	qui	PROrel	_
muneretur	muneror	VER	_
te	tu	PROper	_
Priape	priapus	NOM	_
et	et	CONcoo	_
te	tu	PROper	_
pater	pater	NOM	_
Siluane	siluanus	NOM	_
tutor	tutor	NOM	_
finium	finis	NOM	_

sed	sed	CONcoo	_
iuremus	iuro	VER	_
in	in	PRE	_
haec	hic	PROdem	Neut
simul	simul	CONsub	_
imis	inferus	ADJqua	Com
saxa	saxum	NOM	_
renarint	reno	VER	_
uadis	uadum	NOM	_
leuata	leuo	VER	Neut
ne	ne	ADVneg	_
redire	redeo	VER	_
sit	sum	VER	_
nefas	nefas	NOM	_
neu	neue	CONcoo	_
conuersa	conuerto	VER	Neut
domum	domus	NOM	_
pigeat	piget	VER	_
dare	do	VER	_
lintea	linteum	NOM	_
quando	quando	CONsub	_
Padus	padus	NOM	_
Matina	matinus	ADJqua	Neut
lauerit	lauo	VER	_
cacumina	cacumen	NOM	_
im	in	PRE	_
mare	mare	NOM	_
seu	seu	CONcoo	_
celsus	celsus	ADJqua	Masc
procurrerit	procurro	VER	_
Appenninus	appenninus	NOM	_
noua	nouus	ADJqua	Neut
-que	que	CONcoo	_
monstra	monstrum	NOM	_
iunxerit	iungo	VER	_
libidine	libido	NOM	_
mirus	mirus	ADJqua	Masc
amor	amor	NOM	_
iuuet	iuuo	VER	_
ut	ut	CONsub	_
tigris	tigris	NOM	_
subsidere	subsideo	VER	_
ceruis	ceruus	NOM	_
adulteretur	adultero	VER	_
et	et	CONcoo	_
columba	columba	NOM	_
miluo	miluus	NOM	_
credula	credulus	ADJqua	Neut
nec	nec	CONcoo	_
rauos	rauus	ADJqua	Masc
timeant	timeo	VER	_
armenta	armentum	NOM	_
leones	leo	NOM	_
amet	amo	VER	_
-que	que	CONcoo	_
salsa	salsus	ADJqua	Neut
leuis	leuis	ADJqua	MascFem
hircus	hircus	NOM	_
aequora	aequor	NOM	_

lupis	lupus	NOM	_
et	et	CONcoo	_
agnis	agnus	NOM	_
quanta	quantus	PROrel	Fem
sortito	sortito	ADV	_
obtigit	obtingo	VER	_
te	tu	PROper	_
-cum	cum	PRE	_
mihi	ego	PROper	_
discordia	discordia	NOM	_
est	sum	VER	_
Hibericis	ibericus	ADJqua	Com
peruste	peruro	VER	Masc
funibus	funis	NOM	_
latus	latus	NOM	_
et	et	CONcoo	_
crura	crus	NOM	_
dura	durus	ADJqua	Fem
compede	compes	NOM	_

num	num	ADVint	_
uiperinus	uiperinus	ADJqua	Masc
his	hic	PROdem	Com
cruor	cruor	NOM	_
incoctus	incoquo	VER	Masc
herbis	herba	NOM	_
me	ego	PROper	_
fefellit	fallo	VER	_

curam	cura	NOM	_
metum	metus	NOM	_
-que	que	CONcoo	_
Caesaris	caesar	NOM	_
rerum	res	NOM	_
iuuat	iuuo	VER	_
dulci	dulcis	ADJqua	Com
Lyaeo	lyaeus	NOM	_
soluere	soluo	VER	_

tu	tu	PROper	_
uina	uinum	NOM	_
Torquato	torquatus	NOM	_
moue	moueo	VER	_
consule	consul	NOM	_
pressa	presso	VER	_
meo	meus	PROpos	MascNeut

illic	illic	ADV	_
omne	omnis	PROind	Neut
malum	malum	NOM	_
uino	uinum	NOM	_
cantu	cantus	NOM	_
-que	que	CONcoo	_
leuato	leuo	VER	_
deformis	deformis	ADJqua	Com
aegrimoniae	aegrimonia	NOM	_
dulcibus	dulcis	ADJqua	Com
adloquiis	alloquium	NOM	_

contra	contra	PRE	_
-ne	ne	ADVint	_
lucrum	lucrum	NOM	_
nil	nihil	PROind	_
ualere	ualeo	VER	_
candidum	candidus	ADJqua	MascNeut
pauperis	pauper	ADJqua	Com
ingenium	ingenium	NOM	_
querebar	queror	VER	_
adplorans	apploro	VER	Com
tibi	tu	PROper	_
simul	simul	CONsub	_
calentis	caleo	VER	Com
inuerecundus	inuerencundus	ADJqua	Masc
deus	deus	NOM	_
feruidiore	feruidus	ADJqua	Com
mero	merum	NOM	_
arcana	arcanum	NOM	_
promorat	promoueo	VER	_
loco	locus	NOM	_

uos	uos	PROper	_
turba	turba	NOM	_
uicatim	uicatim	ADV	_
hinc	hinc	ADV	_
et	et	CONcoo	_
hinc	hinc	ADV	_
saxis	saxum	NOM	_
petens	peto	VER	Com
contundet	contundo	VER	_
obscaenas	obscenus	ADJqua	Fem
anus	anus	NOM	_

o	o	INJ	_
rebus	res	NOM	_
meis	meus	PROpos	Com
non	non	ADVneg	_
infideles	infidelis	ADJqua	MascFem
arbitrae	arbitra	NOM	_
Nox	nox	NOM	_
et	et	CONcoo	_
Diana	diana	NOM	_
quae	qui	PROrel	Fem
silentium	silentium	NOM	_
regis	rego	VER	_
arcana	arcanum	NOM	_
cum	cum	CONsub	_
fiunt	fio	VER	_
sacra	sacer	ADJqua	Neut
nunc	nunc	ADV	_
nunc	nunc	ADV	_
adeste	assum	VER	_
nunc	nunc	ADV	_
in	in	PRE	_
hostilis	hostilis	ADJqua	MascFem
domos	domus	NOM	_
iram	ira	NOM	_
atque	atque	CONcoo	_
numen	numen	NOM	_
uertite	uerto	VER	_

effare	effor	VER	_
iussas	iubeo	VER	Fem
cum	cum	PRE	_
fide	fides	NOM	_
poenas	poena	NOM	_
luam	luo	VER	_
paratus	paratus	ADJqua	Masc
expiare	expio	VER	_
seu	seu	CONsub	_
poposceris	posco	VER	_
centum	centum	ADJcar	_
iuuencos	iuuencus	NOM	_
siue	siue	CONsub	_
mendaci	mendax	ADJqua	Com
lyra	lyra	NOM	_
uoles	uolo	VER	_
sonare	sono	VER	_
tu	tu	PROper	_
pudica	pudicus	ADJqua	Fem
tu	tu	PROper	_
proba	probus	ADJqua	Fem
perambulabis	perambulo	VER	_
astra	astrum	NOM	_
sidus	sidus	NOM	_
aureum	aureus	ADJqua	Neut

o	o	INJ	_
ego	ego	PROper	_
non	non	ADVneg	_
felix	felix	ADJqua	Com
quam	qui	PROrel	Fem
tu	tu	PROper	_
fugis	fugio	VER	_
ut	ut	ADVrel	_
pauet	paueo	VER	_
acris	acer	ADJqua	MascFem
agna	agna	NOM	_
lupos	lupus	NOM	_
capreae	caprea	NOM	_
-que	que	CONcoo	_
leones	leo	NOM	_

per	per	PRE	_
liberos	liberi	NOM	_
te	tu	PROper	_
si	si	CONsub	_
uocata	uoco	VER	Fem
partubus	partus	NOM	_
Lucina	lucina	NOM	_
ueris	uerus	ADJqua	Com
adfuit	assum	VER	_
per	per	PRE	_
hoc	hic	PROdem	Neut
inane	inanis	ADJqua	Neut
purpurae	purpura	NOM	_
decus	decus	NOM	_
precor	precor	VER	_
per	per	PRE	_
inprobaturum	improbo	VER	MascNeut
haec	hic	PROdem	Neut
Iouem	iuppiter	NOM	_
quid	quis	PROint	Neut
ut	ut	ADVrel	_
nouerca	nouerca	NOM	_
me	ego	PROper	_
intueris	intueor	VER	_
aut	aut	CONcoo	_
uti	ut	ADVrel	_
petita	peto	VER	Fem
ferro	ferrum	NOM	_
belua	bellua	NOM	_

io	io	INJ	_
Triumphe	triumphus	NOM	_
nec	nec	CONcoo	_
Iugurthino	iugurthinus	ADJqua	MascNeut
parem	par	ADJqua	MascFem
bello	bellum	NOM	_
reportasti	reporto	VER	_
ducem	dux	NOM	_
neque	neque	CONcoo	_
Africanum	africanus	NOM	_
cui	qui	PROrel	Com
super	super	PRE	_
Carthaginem	carthago	NOM	_
uirtus	uirtus	NOM	_
sepulcrum	sepulcrum	NOM	_
condidit	condo	VER	_

quid	quis	PROint	Neut
proderat	prosum	VER	_
ditasse	dito	VER	_
Paelignas	paelignus	ADJqua	Fem
anus	anus	NOM	_
uelocius	uelox	ADJqua	Neut
-ue	ue	CONcoo	_
miscuisse	misceo	VER	_
toxicum	toxicum	NOM	_

parum	parum	NOM	_
-ne	ne	ADVint	_
campis	campus	NOM	_
atque	atque	CONcoo	_
Neptuno	neptunus	NOM	_
super	super	PRE	_
fusum	fundo	VER	Neut
Latini	latinus	ADJqua	MascNeut
sanguinis	sanguis	NOM	_
non	non	ADVneg	_
ut	ut	CONsub	_
superbas	superbus	ADJqua	Fem
inuidae	inuidus	ADJqua	Fem
Karthaginis	carthago	NOM	_
Romanus	romanus	ADJqua	Masc
arces	arx	NOM	_
ureret	uro	VER	_
intactus	intactus	ADJqua	Masc
aut	aut	CONcoo	_
Britannus	britannus	ADJqua	Masc
ut	ut	CONsub	_
descenderet	descendo	VER	_
sacra	sacer	ADJqua	Fem
catenatus	cateno	VER	Masc
uia	uia	NOM	_
sed	sed	CONcoo	_
ut	ut	CONsub	_
secundum	secundum	PRE	_
uota	uotum	NOM	_
Parthorum	parthi	NOM	_
sua	suus	PROpos.ref	Fem
urbs	urbs	NOM	_
haec	hic	PROdem	Fem
periret	pereo	VER	_
dextera	dextera	NOM	_

non	non	ADVneg	_
aliter	aliter	ADV	_
Samio	samius	ADJqua	Masc
dicunt	dico	VER	_
arsisse	ardeo	VER	_
Bathyllo	bathyllus	NOM	_
Anacreonta	anacreon	NOM	_
Teium	teius	ADJqua	MascFem
qui	qui	PROrel	Masc
persaepe	persaepe	ADV	_
caua	cauus	ADJqua	Fem
testudine	testudo	NOM	_
fleuit	fleo	VER	_
amorem	amor	NOM	_
non	non	ADVneg	_
elaboratum	elaboro	VER	MascNeut
ad	ad	PRE	_
pedem	pes	NOM	_

neque	neque	CONcoo	_
hic	hic	PROdem	Masc
lupis	lupus	NOM	_
mos	mos	NOM	_
nec	nec	CONcoo	_
fuit	sum	VER	_
leonibus	leo	NOM	_
umquam	umquam	ADV	_
nisi	nisi	CONsub	_
in	in	PRE	_
dispar	dispar	ADJqua	Neut
feris	ferus	ADJqua	Com

quis	quis	PROint	MascFem
non	non	ADVneg	_
malarum	malus	ADJqua	Fem
quas	qui	PROrel	Fem
amor	amor	NOM	_
curas	cura	NOM	_
habet	habeo	VER	_
haec	hic	PROdem	Neut
inter	inter	PRE	_
obliuiscitur	obliuiscor	VER	_

nox	nox	NOM	_
erat	sum	VER	_
et	et	CONcoo	_
caelo	caelum	NOM	_
fulgebat	fulgeo	VER	_
Luna	luna	NOM	_
sereno	serenus	ADJqua	MascNeut
inter	inter	PRE	_
minora	paruus	ADJqua	Neut
sidera	sidus	NOM	_
cum	cum	CONsub	_
tu	tu	PROper	_
magnorum	magnus	ADJqua	MascNeut
numen	numen	NOM	_
laesura	laedo	VER	Fem
deorum	deus	NOM	_
in	in	PRE	_
uerba	uerbum	NOM	_
iurabas	iuro	VER	_
mea	meus	PROpos	Neut
artius	arte	ADV	_
atque	atque	CONsub	_
hedera	hedera	NOM	_
procera	procerus	ADJqua	Fem
adstringitur	astringo	VER	_
ilex	ilex	NOM	_
lentis	lentus	ADJqua	Com
adhaerens	adhaereo	VER	Com
bracchiis	brachium	NOM	_
dum	dum	CONsub	_
pecori	pecus	NOM	_
lupus	lupus	NOM	_
et	et	CONcoo	_
nautis	nauta	NOM	_
infestus	infestus	ADJqua	Masc
Orion	orion	NOM	_
turbaret	turbo	VER	_
hibernum	hibernus	ADJqua	MascNeut
mare	mare	NOM	_
intonsos	intonsus	ADJqua	Masc
-que	que	CONcoo	_
agitaret	agito	VER	_
Apollinis	apollo	NOM	_
aura	aura	NOM	_
capillos	capillus	NOM	_
fore	sum	VER	_
hunc	hic	PROdem	Masc
amorem	amor	NOM	_
mutuum	mutuus	ADJqua	MascNeut
o	o	INJ	_
dolitura	doleo	VER	Fem
mea	meus	PROpos	Fem
multum	multum	ADV	_
uirtute	uirtus	NOM	_
Neaera	neaerea	NOM	_
nam	nam	CONcoo	_
si	si	CONsub	_
quid	quis	PROind	Neut
in	in	PRE	_
Flacco	flaccus	NOM	_
uiri	uir	NOM	_
est	sum	VER	_
non	non	ADVneg	_
feret	fero	VER	_
adsiduas	assiduus	ADJqua	Fem
potiori	potis	ADJqua	Com
te	tu	PROper	_
dare	do	VER	_
noctes	nox	NOM	_
et	et	CONcoo	_
quaeret	quaero	VER	_
iratus	iratus	ADJqua	Masc
parem	par	NOM	_
nec	nec	CONcoo	_
semel	semel	ADJadv.mul	_
offensi	offendo	VER	MascNeut
cedet	cedo	VER	_
constantia	constantia	NOM	_
formae	forma	NOM	_
si	si	CONsub	_
certus	certus	ADJqua	Masc
intrarit	intro	VER	_
dolor	dolor	NOM	_

esto	sum	VER	_
beata	beatus	ADJqua	Fem
funus	funus	NOM	_
atque	atque	CONcoo	_
imagines	imago	NOM	_
ducant	duco	VER	_
triumphales	triumphalis	ADJqua	MascFem
tuum	tuus	PROpos	MascNeut
nec	nec	CONcoo	_
sit	sum	VER	_
marita	marita	NOM	_
quae	qui	PROrel	Fem
rotundioribus	rotundus	ADJqua	Com
onusta	onustus	ADJqua	Fem
bacis	bacca	NOM	_
ambulet	ambulo	VER	_

forte	forte	ADV	_
quid	quis	PROint	Neut
expediat	expedio	VER	_
communiter	communiter	ADV	_
aut	aut	CONcoo	_
melior	bonus	ADJqua	MascFem
pars	pars	NOM	_
malis	malus	ADJqua	Com
carere	careo	VER	_
quaeritis	quaero	VER	_
laboribus	labor	NOM	_

uectabor	uecto	VER	_
umeris	humerus	NOM	_
tunc	tunc	ADV	_
ego	ego	PROper	_
inimicis	inimicus	ADJqua	Com
eques	eques	NOM	_
meae	meus	PROpos	Fem
-que	que	CONcoo	_
terra	terra	NOM	_
cedet	cedo	VER	_
insolentiae	insolentia	NOM	_

responsum	responsum	NOM	_
date	do	VER	_

an	an	ADVint	_
quae	qui	PROrel	Fem
mouere	moueo	VER	_
cereas	cereus	ADJqua	Fem
imagines	imago	NOM	_
ut	ut	ADVrel	_
ipse	ipse	PROdem	Masc
nosti	nosco	VER	_
curiosus	curiosus	ADJqua	Masc
et	et	CONcoo	_
polo	polus	NOM	_
deripere	deripio	VER	_
lunam	luna	NOM	_
uocibus	uox	NOM	_
possim	possum	VER	_
meis	meus	PROpos	Com
possim	possum	VER	_
crematos	cremo	VER	Masc
excitare	excito	VER	_
mortuos	mortuus	NOM	_
desideri	desiderium	NOM	_
-que	que	CONcoo	_
temperare	tempero	VER	_
pocula	poculum	NOM	_
plorem	ploro	VER	_
artis	ars	NOM	_
in	in	PRE	_
te	tu	PROper	_
nil	nihil	PROind	_
agentis	ago	VER	Com
exitus	exitus	NOM	_

qui	quis	PROint	Masc
sudor	sudor	NOM	_
uietis	uietus	ADJqua	Com
et	et	CONcoo	_
quam	quam	ADVint	_
malus	malus	ADJqua	Masc
undique	undique	ADV	_
membris	membrum	NOM	_
crescit	cresco	VER	_
odor	odor	NOM	_
cum	cum	CONsub	_
pene	penis	NOM	_
soluto	soluo	VER	MascNeut
indomitam	indomitus	ADJqua	Fem
properat	propero	VER	_
rabiem	rabies	NOM	_
sedare	sedo	VER	_
neque	neque	CONcoo	_
illi	ille	PROdem	Com
iam	iam	ADV	_
manet	maneo	VER	_
umida	humidus	ADJqua	Fem
creta	creta	NOM	_
color	color	NOM	_
-que	que	CONcoo	_
stercore	stercus	NOM	_
fucatus	fuco	VER	Masc
crocodili	crocodilus	NOM	_
iam	iam	ADV	_
-que	que	CONcoo	_
subando	subo	VER	_
tenta	tendo	VER	Neut
cubilia	cubile	NOM	_
tecta	tectum	NOM	_
-que	que	CONcoo	_
rumpit	rumpo	VER	_
uel	uel	CONcoo	_
mea	meus	PROpos	Neut
cum	cum	PRE	_
saeuis	saeuus	ADJqua	Com
agitat	agito	VER	_
fastidia	fastidium	NOM	_
uerbis	uerbum	NOM	_
Inachia	inachia	NOM	_
langues	langueo	VER	_
minus	parum	ADV	_
ac	ac	CONsub	_
me	ego	PROper	_
Inachiam	inachia	NOM	_
ter	ter	ADJadv.mul	_
nocte	nox	NOM	_
potes	possum	VER	_
mihi	ego	PROper	_
semper	semper	ADV	_
ad	ad	PRE	_
unum	unus	ADJcar	MascNeut
mollis	mollio	VER	_
opus	opus	NOM	_

an	an	ADVint	_
melius	bene	ADV	_
quis	quis	PROind	MascFem
habet	habeo	VER	_
suadere	suadeo	VER	_

sed	sed	CONcoo	_
tardiora	tardus	ADJqua	Neut
fata	fatum	NOM	_
te	tu	PROper	_
uotis	uotum	NOM	_
manent	maneo	VER	_
ingrata	ingratus	ADJqua	Fem
misero	miser	ADJqua	MascNeut
uita	uita	NOM	_
ducenda	duco	VER	Fem
est	sum	VER	_
in	in	PRE	_
hoc	hic	PROdem	MascNeut
nouis	nouus	ADJqua	Com
ut	ut	CONsub	_
usque	usque	ADV	_
suppetas	suppeto	VER	_
laboribus	labor	NOM	_

quid	quis	PROint	Neut
hoc	hic	PROdem	Neut
ueneni	uenenum	NOM	_
saeuit	saeuio	VER	_
in	in	PRE	_
praecordiis	praecordia	NOM	_

non	non	ADVneg	_
usitatis	usitatus	ADJqua	Com
Vare	uarus	NOM	_
potionibus	potio	NOM	_
o	o	INJ	_
multa	multus	ADJqua	Neut
fleturum	fleo	VER	Neut
caput	caput	NOM	_
ad	ad	PRE	_
me	ego	PROper	_
recurres	recurro	VER	_
nec	nec	CONcoo	_
uocata	uoco	VER	Fem
mens	mens	NOM	_
tua	tuus	PROpos	Fem
Marsis	marsus	ADJqua	Com
redibit	redeo	VER	_
uocibus	uox	NOM	_
maius	magnus	ADJqua	Neut
parabo	paro	VER	_
maius	magnus	ADJqua	Neut
infundam	infundo	VER	_
tibi	tu	PROper	_
fastidienti	fastidio	VER	Com
poculum	poculum	NOM	_
-que	que	CONcoo	_
caelum	caelum	NOM	_
sidet	sido	VER	_
inferius	inferus	ADJqua	Neut
mari	mare	NOM	_
tellure	tellus	NOM	_
porrecta	porrigo	VER	Fem
super	super	ADV	_
quam	priusquam	CONsub	_
non	non	ADVneg	_
amore	amor	NOM	_
sic	sic	ADV	_
meo	meus	PROpos	MascNeut
flagres	flagro	VER	_
uti	ut	ADVrel	_
bitumen	bitumen	NOM	_
atris	ater	ADJqua	Com
ignibus	ignis	NOM	_

at	at	CONcoo	_
o	o	INJ	_
deorum	deus	NOM	_
quidquid	quisquis	PROrel	Neut
in	in	PRE	_
caelo	caelum	NOM	_
regit	rego	VER	_
terras	terra	NOM	_
et	et	CONcoo	_
humanum	humanus	ADJqua	MascNeut
genus	genus	NOM	_
quid	quis	PROint	Neut
iste	iste	PROdem	Masc
fert	fero	VER	_
tumultus	tumultus	NOM	_

quid	quis	PROint	Neut
quod	quod	CONsub	_
libelli	libellus	NOM	_
Stoici	stoicus	ADJqua	Masc
inter	inter	PRE	_
Sericos	sericus	ADJqua	Masc
iacere	iaceo	VER	_
puluillos	puluillus	NOM	_
amant	amo	VER	_
inlitterati	illitteratus	ADJqua	Masc
num	num	ADVint	_
minus	parum	ADV	_
nerui	neruus	NOM	_
rigent	rigeo	VER	_
minus	parum	ADV	_
-ue	ue	CONcoo	_
languet	langueo	VER	_
fascinum	fascinum	NOM	_

non	non	ADVneg	_
defuisse	desum	VER	_
masculae	masculus	ADJqua	Fem
libidinis	libido	NOM	_
Ariminensem	arimiensis	ADJqua	Masc
Foliam	folia	NOM	_
et	et	CONcoo	_
otiosa	otiosus	ADJqua	Fem
credidit	credo	VER	_
Neapolis	neapolis	NOM	_
et	et	CONcoo	_
omne	omnis	PROind	Neut
uicinum	uicinus	ADJqua	Neut
oppidum	oppidum	NOM	_
quae	qui	PROrel	Fem
sidera	sidus	NOM	_
excantata	excanto	VER	Fem
uoce	uox	NOM	_
Thessala	thessalus	ADJqua	Fem
lunam	luna	NOM	_
-que	que	CONcoo	_
caelo	caelum	NOM	_
deripit	deripio	VER	_

caue	caueo	VER	_
caue	caueo	VER	_
namque	namque	CONcoo	_
in	in	PRE	_
malos	mali	NOM	_
asperrimus	asper	ADJqua	Masc
parata	paratus	ADJqua	Neut
tollo	tollo	VER	_
cornua	cornu	NOM	_
qualis	qualis	PROrel	MascFem
Lycambae	lycambes	NOM	_
spretus	sperno	VER	Masc
infido	infidus	ADJqua	MascNeut
gener	gener	NOM	_
aut	aut	CONcoo	_
acer	acer	ADJqua	Masc
hostis	hostis	NOM	_
Bupalo	bupalus	NOM	_

io	io	INJ	_
Triumphe	triumphus	NOM	_
tu	tu	PROper	_
moraris	moror	VER	_
aureos	aureus	ADJqua	Masc
currus	currus	NOM	_
et	et	CONcoo	_
intactas	intactus	ADJqua	Fem
boues	bos	NOM	_

namque	namque	CONcoo	_
sagacius	sagaciter	ADV	_
unus	unus	ADJcar	Masc
odoror	odoror	VER	_
polypus	polypus	NOM	_
an	an	ADVint	_
grauis	grauis	ADJqua	MascFem
hirsutis	hirsutus	ADJqua	Com
cubet	cubo	VER	_
hircus	hircus	NOM	_
in	in	PRE	_
alis	ala	NOM	_
quam	quam	ADVrel	_
canis	canis	NOM	_
acer	acer	ADJqua	Masc
ubi	ubi	ADVint	_
lateat	lateo	VER	_
sus	sus	NOM	_

libet	libet	VER	_
iacere	iaceo	VER	_
modo	modo	ADV	_
sub	sub	PRE	_
antiqua	antiquus	ADJqua	Fem
ilice	ilex	NOM	_
modo	modo	ADV	_
in	in	PRE	_
tenaci	tenax	ADJqua	Com
gramine	gramen	NOM	_
labuntur	labor	VER	_
altis	altum	NOM	_
interim	interim	ADV	_
ripis	ripa	NOM	_
aquae	aqua	NOM	_
queruntur	queror	VER	_
in	in	PRE	_
siluis	silua	NOM	_
aues	auis	NOM	_
fontes	fons	NOM	_
-que	que	CONcoo	_
lymphis	lympha	NOM	_
obstrepunt	obstrepo	VER	_
manantibus	mano	VER	Com
somnos	somnus	NOM	_
quod	qui	PROrel	Neut
inuitet	inuito	VER	_
leuis	leuis	ADJqua	MascFem

quid	quis	PROint	Neut
obseratis	obsero	VER	Com
auribus	auris	NOM	_
fundis	fundo	VER	_
preces	prex	NOM	_

ibis	eo	VER	_
Liburnis	liburnae	NOM	_
inter	inter	PRE	_
alta	altus	ADJqua	Neut
nauium	nauis	NOM	_
amice	amicus	ADJqua	Masc
propugnacula	propugnaculum	NOM	_
paratus	paratus	ADJqua	Masc
omne	omnis	PROind	Neut
Caesaris	caesar	NOM	_
periculum	periculum	NOM	_
subire	subeo	VER	_
Maecenas	maecenas	NOM	_
tuo	tuus	PROpos	MascNeut
quid	quis	PROint	Neut
nos	nos	PROper	_
quibus	qui	PROrel	Com
te	tu	PROper	_
uita	uita	NOM	_
si	si	CONsub	_
superstite	superstes	ADJqua	Com
iucunda	iucundus	ADJqua	Fem
si	si	CONsub	_
contra	contra	ADV	_
grauis	grauis	ADJqua	MascFem

et	et	CONcoo	_
tu	tu	PROper	_
quicumque	quicumque	PROrel	Masc
es	sum	VER	_
felicior	felix	ADJqua	MascFem
atque	atque	CONcoo	_
meo	meus	PROpos	MascNeut
nunc	nunc	ADV	_
superbus	superbus	ADJqua	Masc
incedis	incedo	VER	_
malo	malum	NOM	_
sis	sum	VER	_
pecore	pecus	NOM	_
et	et	CONcoo	_
multa	multus	ADJqua	Fem
diues	diues	ADJqua	Com
tellure	tellus	NOM	_
licebit	licet	VER	_
tibi	tu	PROper	_
-que	que	CONcoo	_
Pactolus	pactolus	NOM	_
fluat	fluo	VER	_
nec	nec	CONcoo	_
te	tu	PROper	_
Pythagorae	pythagoras	NOM	_
fallant	fallo	VER	_
arcana	arcanum	NOM	_
renati	renascor	VER	MascNeut
forma	forma	NOM	_
-que	que	CONcoo	_
uincas	uinco	VER	_
Nirea	nireus	NOM	_
heu	heu	INJ	_
heu	heu	INJ	_
translatos	transfero	VER	Masc
alio	alio	ADV	_
maerebis	maereo	VER	_
amores	amor	NOM	_
ast	at	CONcoo	_
ego	ego	PROper	_
uicissim	uicissim	ADV	_
risero	rideo	VER	_

mouit	moueo	VER	_
nepotem	nepos	NOM	_
Telephus	telephus	NOM	_
Nereium	nereius	ADJqua	MascNeut
in	in	PRE	_
quem	qui	PROrel	Masc
superbus	superbus	ADJqua	Masc
ordinarat	ordino	VER	_
agmina	agmen	NOM	_
Mysorum	mysi	NOM	_
et	et	CONcoo	_
in	in	PRE	_
quem	qui	PROrel	Masc
tela	telum	NOM	_
acuta	acutus	ADJqua	Neut
torserat	torqueo	VER	_
unxere	ungo	VER	_
matres	mater	NOM	_
Iliae	ilius	ADJqua	Fem
additum	addo	VER	MascNeut
feris	fera	NOM	_
alitibus	ales	NOM	_
atque	atque	CONcoo	_
canibus	canis	NOM	_
homicidam	homicida	NOM	_
Hectorem	hector	NOM	_
postquam	postquam	CONsub	_
relictis	relinquo	VER	Com
moenibus	moenia	NOM	_
rex	rex	NOM	_
procidit	procido	VER	_
heu	heu	INJ	_
peruicacis	paruicax	ADJqua	Com
ad	ad	PRE	_
pedes	pes	NOM	_
Achillei	achilles	NOM	_
saetosa	saetosus	ADJqua	Neut
duris	durus	ADJqua	Com
exuere	exuo	VER	_
pellibus	pellis	NOM	_
laboriosi	laboriosus	ADJqua	Masc
remiges	remex	NOM	_
Vlixei	ulixeus	NOM	_
uolente	uolo	VER	Com
Circa	circe	NOM	_
membra	membrum	NOM	_
tunc	tunc	ADV	_
mens	mens	NOM	_
et	et	CONcoo	_
sonus	sonus	NOM	_
relapsus	relabor	VER	Masc
atque	atque	CONcoo	_
notus	notus	ADJqua	Masc
in	in	PRE	_
uoltus	uultus	NOM	_
honor	honor	NOM	_

munera	munus	NOM	_
quid	quis	PROint	Neut
mihi	ego	PROper	_
quid	quis	PROint	Neut
-ue	ue	CONcoo	_
tabellas	tabella	NOM	_
mittis	mitto	VER	_
nec	nec	CONcoo	_
firmo	firmus	ADJqua	MascNeut
iuueni	iuuenis	NOM	_
neque	neque	CONcoo	_
naris	naris	NOM	_
obesae	obesus	ADJqua	Fem

sed	sed	CONcoo	_
incitat	incito	VER	_
me	ego	PROper	_
pectus	pectus	NOM	_
et	et	CONcoo	_
mammae	mamma	NOM	_
putres	putris	ADJqua	MascFem
equina	equinus	ADJqua	Neut
quales	qualis	PROrel	MascFem
ubera	uber	NOM	_
uenter	uenter	NOM	_
-que	que	CONcoo	_
mollis	mollis	ADJqua	MascFem
et	et	CONcoo	_
femur	femur	NOM	_
tumentibus	tumeo	VER	Com
exile	exilis	ADJqua	Neut
suris	sura	NOM	_
additum	addo	VER	Neut

quod	quod	CONcoo	_
si	si	CONsub	_
pudica	pudicus	ADJqua	Fem
mulier	mulier	NOM	_
in	in	PRE	_
partem	pars	NOM	_
iuuet	iuuo	VER	_
domum	domus	NOM	_
atque	atque	CONcoo	_
dulcis	dulcis	ADJqua	MascFem
liberos	liberi	NOM	_
Sabina	sabinus	ADJqua	Fem
qualis	qualis	PROrel	MascFem
aut	aut	CONcoo	_
perusta	peruro	VER	Fem
solibus	sol	NOM	_
pernicis	pernix	ADJqua	Com
uxor	uxor	NOM	_
Apuli	apulus	ADJqua	MascFem
sacrum	sacer	ADJqua	MascNeut
uetustis	uetustus	ADJqua	Com
exstruat	exstruo	VER	_
lignis	lignum	NOM	_
focum	focus	NOM	_
lassi	lassus	ADJqua	MascNeut
sub	sub	PRE	_
aduentum	aduentus	NOM	_
uiri	uir	NOM	_
claudens	claudo	VER	Com
-que	que	CONcoo	_
textis	texo	VER	Com
cratibus	crates	NOM	_
laetum	laetus	ADJqua	MascNeut
pecus	pecus	NOM	_
distenta	distendo	VER	Neut
siccet	sicco	VER	_
ubera	uber	NOM	_
et	et	CONcoo	_
horna	hornus	ADJqua	Neut
dulci	dulcis	ADJqua	Com
uina	uinum	NOM	_
promens	promo	VER	Com
dolio	dolium	NOM	_
dapes	daps	NOM	_
inemptas	inemptus	ADJqua	Fem
adparet	apparo	VER	_
non	non	ADVneg	_
me	ego	PROper	_
Lucrina	lucrinus	ADJqua	Neut
iuuerint	iuuo	VER	_
conchylia	conchylium	NOM	_
magis	magis	ADV	_
-ue	ue	CONcoo	_
rhombus	rhombos	NOM	_
aut	aut	CONcoo	_
scari	scarus	NOM	_
si	si	CONsub	_
quos	quis	PROind	Masc
Eois	eous	ADJqua	Com
intonata	intono	VER	Fem
fluctibus	fluctus	NOM	_
hiems	hiems	NOM	_
ad	ad	PRE	_
hoc	hic	PROdem	Neut
uertat	uerto	VER	_
mare	mare	NOM	_
non	non	ADVneg	_
Afra	afer	ADJqua	Fem
auis	auis	NOM	_
descendat	descendo	VER	_
in	in	PRE	_
uentrem	uenter	NOM	_
meum	meus	PROpos	MascNeut
non	non	ADVneg	_
attagen	attagen	NOM	_
Ionicus	ionicus	ADJqua	Masc
iucundior	iucundus	ADJqua	MascFem
quam	quam	ADVrel	_
lecta	lego	VER	Fem
de	de	PRE	_
pinguissimis	pinguis	ADJqua	Com
oliua	oliua	NOM	_
ramis	ramus	NOM	_
arborum	arbor	NOM	_
aut	aut	CONcoo	_
herba	herba	NOM	_
lapathi	lapathus	NOM	_
prata	pratum	NOM	_
amantis	amo	VER	Com
et	et	CONcoo	_
graui	grauis	ADJqua	Com
maluae	malua	NOM	_
salubres	saluber	ADJqua	MascFem
corpori	corpus	NOM	_
uel	uel	CONcoo	_
agna	agna	NOM	_
festis	festus	ADJqua	Com
caesa	caedo	VER	Fem
terminalibus	terminalia	NOM	_
uel	uel	CONcoo	_
haedus	haedus	NOM	_
ereptus	eripio	VER	Masc
lupo	lupus	NOM	_

at	at	CONcoo	_
huc	huc	ADV	_
frementis	fremo	VER	MascFem
uerterunt	uerto	VER	_
bis	bis	ADJadv.mul	_
mille	mille	ADJcar	_
equos	equus	NOM	_
Galli	galli	NOM	_
canentes	cano	VER	MascFem
Caesarem	caesar	NOM	_
hostilium	hostilis	ADJqua	Com
-que	que	CONcoo	_
nauium	nauis	NOM	_
portu	portus	NOM	_
latent	lateo	VER	_
puppes	puppis	NOM	_
sinistrorsum	sinistrorsus	ADV	_
citae	cieo	VER	Fem

terra	terra	NOM	_
mari	mare	NOM	_
-que	que	CONcoo	_
uictus	uinco	VER	Masc
hostis	hostis	NOM	_
punico	punicius	ADJqua	MascNeut
lugubre	lugubris	ADJqua	Neut
mutauit	muto	VER	_
sagum	sagum	NOM	_
aut	aut	CONcoo	_
ille	ille	PROdem	Masc
centum	centum	ADJcar	_
nobilem	nobilis	ADJqua	MascFem
Cretam	creta	NOM	_
urbibus	urbs	NOM	_
uentis	uentus	NOM	_
iturus	eo	VER	Masc
non	non	ADVneg	_
suis	suus	PROpos.ref	Com
exercitatas	exercito	VER	Fem
aut	aut	CONcoo	_
petit	peto	VER	_
Syrtis	syrtis	NOM	_
Noto	notus	NOM	_
aut	aut	CONcoo	_
fertur	fero	VER	_
incerto	incertus	ADJqua	MascNeut
mari	mare	NOM	_

nec	nec	CONcoo	_
tantus	tantus	PROdem	Masc
unquam	umquam	ADV	_
siderum	sidus	NOM	_
insedit	insideo	VER	_
uapor	uapor	NOM	_
siticulosae	siticulosus	ADJqua	Fem
Apuliae	apulia	NOM	_
nec	nec	ADVneg	_
munus	munus	NOM	_
umeris	humerus	NOM	_
efficacis	efficax	ADJqua	Com
Herculis	hercules	NOM	_
inarsit	inardeo	VER	_
aestuosius	aestuose	ADV	_

quid	quis	PROint	Neut
attinet	attineo	VER	_
tot	tot	PROdem	_
ora	os	NOM	_
nauium	nauis	NOM	_
graui	grauis	ADJqua	Com
rostrata	rostratus	ADJqua	Fem
duci	duco	VER	_
pondere	pondus	NOM	_
contra	contra	PRE	_
latrones	latro	NOM	_
atque	atque	CONcoo	_
seruilem	seruilis	ADJqua	MascFem
manum	manus	NOM	_
hoc	hic	PROdem	MascNeut
hoc	hic	PROdem	MascNeut
tribuno	tribunus	NOM	_
militum	miles	NOM	_

nam	nam	CONcoo	_
qualis	qualis	PROrel	MascFem
aut	aut	CONcoo	_
Molossus	molossus	ADJqua	Masc
aut	aut	CONcoo	_
fuluos	fuluus	ADJqua	Masc
Lacon	lacon	ADJqua	Com
amica	amicus	ADJqua	Fem
uis	uis	NOM	_
pastoribus	pastor	NOM	_
agam	ago	VER	_
per	per	PRE	_
altas	altus	ADJqua	Fem
aure	auris	NOM	_
sublata	suffero	VER	Fem
niuis	nix	NOM	_
quaecumque	quicumque	PROrel	Fem
praecedet	praecedo	VER	_
fera	fera	NOM	_
tu	tu	PROper	_
cum	cum	CONsub	_
timenda	timeo	VER	Fem
uoce	uox	NOM	_
complesti	compleo	VER	_
nemus	nemus	NOM	_
proiectum	proicio	VER	MascNeut
odoraris	odoro	VER	_
cibum	cibus	NOM	_

o	o	INJ	_
dura	durus	ADJqua	Neut
messorum	messor	NOM	_
ilia	ilia	NOM	_

Iuppiter	iuppiter	NOM	_
illa	ille	PROdem	Neut
piae	pius	ADJqua	Fem
secreuit	secerno	VER	_
litora	litus	NOM	_
genti	gens	NOM	_
ut	ut	CONsub	_
inquinauit	inquino	VER	_
aere	aes	NOM	_
tempus	tempus	NOM	_
aureum	aureus	ADJqua	MascNeut
aere	aes	NOM	_
dehinc	dehinc	ADV	_
ferro	ferrum	NOM	_
durauit	duro	VER	_
saecula	saeculum	NOM	_
quorum	qui	PROrel	MascNeut
piis	pius	ADJqua	Com
secunda	secundus	ADJqua	Fem
uate	uates	NOM	_
me	ego	PROper	_
datur	do	VER	_
fuga	fuga	NOM	_

Romanus	romanus	ADJqua	Masc
eheu	eheu	INJ	_
posteri	posteri	NOM	_
negabitis	nego	VER	_
emancipatus	emancipo	VER	Masc
feminae	femina	NOM	_
fert	fero	VER	_
uallum	uallus	NOM	_
et	et	CONcoo	_
arma	arma	NOM	_
miles	miles	NOM	_
et	et	CONcoo	_
spadonibus	spado	NOM	_
seruire	seruio	VER	_
rugosis	rugosus	ADJqua	Com
potest	possum	VER	_
inter	inter	PRE	_
-que	que	CONcoo	_
signa	signum	NOM	_
turpe	turpis	ADJqua	Neut
militaria	militaris	ADJqua	Neut
sol	sol	NOM	_
adspicit	aspicio	VER	_
conopium	conopeum	NOM	_

quam	qui	PROrel	Fem
neque	neque	CONcoo	_
finitimi	finitimus	ADJqua	Masc
ualuerunt	ualeo	VER	_
perdere	perdo	VER	_
Marsi	marsi	NOM	_
minacis	minax	ADJqua	Com
aut	aut	CONcoo	_
Etrusca	etruscus	ADJqua	Fem
Porsenae	porsena	NOM	_
manus	manus	NOM	_
aemula	aemulus	ADJqua	Fem
nec	nec	CONcoo	_
uirtus	uirtus	NOM	_
Capuae	capua	NOM	_
nec	nec	CONcoo	_
Spartacus	spartacus	NOM	_
acer	acer	ADJqua	Masc
nouis	nouus	ADJqua	Com
-que	que	CONcoo	_
rebus	res	NOM	_
infidelis	infidelis	ADJqua	MascFem
Allobrox	allobrox	ADJqua	Com
nec	nec	CONcoo	_
fera	ferus	ADJqua	Fem
caerulea	caeruleus	ADJqua	Fem
domuit	domo	VER	_
Germania	germania	NOM	_
pube	pubes	NOM	_
parentibus	parens	NOM	_
-que	que	CONcoo	_
abominatus	abominor	VER	Masc
Hannibal	hannibal	NOM	_
inpia	impius	ADJqua	Fem
perdemus	perdo	VER	_
deuoti	deuoueo	VER	MascNeut
sanguinis	sanguis	NOM	_
aetas	aetas	NOM	_
feris	fera	NOM	_
-que	que	CONcoo	_
rursus	rursus	ADV	_
occupabitur	occupo	VER	_
solum	solum	NOM	_
barbarus	barbarus	NOM	_
heu	heu	INJ	_
cineres	cinis	NOM	_
insistet	insisto	VER	_
uictor	uictor	NOM	_
et	et	CONcoo	_
urbem	urbs	NOM	_
eques	eques	NOM	_
sonante	sono	VER	Com
uerberabit	uerbero	VER	_
ungula	ungula	NOM	_
quae	qui	PROrel	Neut
-que	que	CONcoo	_
carent	careo	VER	_
uentis	uentus	NOM	_
et	et	CONcoo	_
solibus	sol	NOM	_
ossa	os	NOM	_
Quirini	quarinus	NOM	_
nefas	nefas	NOM	_
uidere	uideo	VER	_
dissipabit	dissipo	VER	_
insolens	insolens	ADJqua	Com

parentis	parens	NOM	_
olim	olim	ADV	_
si	si	CONsub	_
quis	quis	PROind	MascFem
inpia	impius	ADJqua	Fem
manu	manus	NOM	_
senile	senilis	ADJqua	Neut
guttur	guttur	NOM	_
fregerit	frango	VER	_
edit	edo	VER	_
cicutis	cicuta	NOM	_
alium	allium	NOM	_
nocentius	nocens	ADJqua	Neut

an	an	ADVint	_
malas	malus	ADJqua	Fem
canidia	canidia	NOM	_
tractauit	tracto	VER	_
dapes	daps	NOM	_

aut	aut	CONcoo	_
cur	cur	ADVint	_
dexteris	dextera	NOM	_
aptantur	apto	VER	_
enses	ensis	NOM	_
conditi	condo	VER	Masc

abacta	abigo	VER	Fem
nulla	nullus	PROind	Fem
Veia	ueia	NOM	_
conscientia	conscientia	NOM	_
ligonibus	ligo	NOM	_
duris	durus	ADJqua	Com
humum	humus	NOM	_
exhauriebat	exhaurio	VER	_
ingemens	ingemo	VER	Com
laboribus	labor	NOM	_
quo	quo	CONsub	_
posset	possum	VER	_
infossus	infodio	VER	Masc
puer	puer	NOM	_
longo	longus	ADJqua	MascNeut
die	dies	NOM	_
bis	bis	ADJadv.mul	_
ter	ter	ADJadv.mul	_
-que	que	CONcoo	_
mutatae	muto	VER	Fem
dapis	daps	NOM	_
inemori	inemorior	VER	_
spectaculo	spectaculum	NOM	_
cum	cum	CONsub	_
promineret	promineo	VER	_
ore	os	NOM	_
quantum	quantum	ADVrel	_
exstant	exsto	VER	_
aqua	aqua	NOM	_
suspensa	suspendo	VER	Neut
mento	mentum	NOM	_
corpora	corpus	NOM	_
exsecta	exseco	VER	Fem
uti	ut	CONsub	_
medulla	medulla	NOM	_
et	et	CONcoo	_
aridum	aridus	ADJqua	Neut
iecur	iecur	NOM	_
amoris	amor	NOM	_
esset	sum	VER	_
poculum	poculum	NOM	_
interminato	intermino	VER	MascNeut
cum	cum	CONsub	_
semel	semel	ADJadv.mul	_
fixae	figo	VER	Fem
cibo	cibus	NOM	_
intabuissent	intabesco	VER	_
pupulae	pupula	NOM	_

haec	hic	PROdem	Neut
ubi	ubi	CONsub	_
locutus	loquor	VER	Masc
faenerator	fenerator	NOM	_
Alfius	alfius	NOM	_
iamiam	iamiam	ADV	_
futurus	futurus	ADJqua	Masc
rusticus	rusticus	NOM	_
omnem	omnis	PROind	MascFem
redegit	redigo	VER	_
idibus	idus	NOM	_
pecuniam	pecunia	NOM	_
quaerit	quaero	VER	_
kalendis	kalendae	NOM	_
ponere	pono	VER	_

an	an	ADVint	_
si	si	CONsub	_
quis	quis	PROind	MascFem
atro	ater	ADJqua	MascNeut
dente	dens	NOM	_
me	ego	PROper	_
petiuerit	peto	VER	_
inultus	inultus	ADJqua	Masc
ut	ut	ADVrel	_
flebo	fleo	VER	_
puer	puer	NOM	_

quid	quis	PROint	Neut
tibi	tu	PROper	_
uis	uolo	VER	_
mulier	mulier	NOM	_
nigris	niger	ADJqua	Com
dignissima	dignus	ADJqua	Fem
barris	barrus	NOM	_

satis	satis	ADV	_
super	super	ADV	_
-que	que	CONcoo	_
me	ego	PROper	_
benignitas	benignitas	NOM	_
tua	tuus	PROpos	Fem
ditauit	dito	VER	_
haud	haud	ADVneg	_
parauero	paro	VER	_
quod	qui	PROrel	Neut
aut	aut	CONcoo	_
auarus	auarus	ADJqua	Masc
ut	ut	ADVrel	_
Chremes	chremes	NOM	_
terra	terra	NOM	_
premam	premo	VER	_
discinctus	discingo	VER	Masc
aut	aut	CONcoo	_
perdam	perdo	VER	_
nepos	nepos	NOM	_

quod	quod	CONcoo	_
si	si	CONsub	_
non	non	ADVneg	_
pulcrior	pulcher	ADJqua	MascFem
ignis	ignis	NOM	_
accendit	accendo	VER	_
obsessam	obsideo	VER	Fem
Ilion	ilium	NOM	_
gaude	gaudeo	VER	_
sorte	sors	NOM	_
tua	tuus	PROpos	Fem
me	ego	PROper	_
libertina	libertinus	ADJqua	Fem
nec	nec	CONcoo	_
uno	unus	ADJcar	MascNeut
contenta	contentus	ADJqua	Fem
Phryne	phryne	NOM	_
macerat	macero	VER	_

rogare	rogo	VER	_
longo	longus	ADJqua	MascNeut
putidam	putidus	ADJqua	Fem
te	tu	PROper	_
saeculo	saeculum	NOM	_
uiris	uir	NOM	_
quid	quis	PROint	Neut
eneruet	eneruo	VER	_
meas	meus	PROpos	Fem
cum	cum	CONsub	_
sit	sum	VER	_
tibi	tu	PROper	_
dens	dens	NOM	_
ater	ater	ADJqua	Masc
et	et	CONcoo	_
rugis	ruga	NOM	_
uetus	uetus	ADJqua	Com
frontem	frons	NOM	_
senectus	senectus	NOM	_
exaret	exaro	VER	_
hiet	hio	VER	_
-que	que	CONcoo	_
turpis	turpis	ADJqua	MascFem
inter	inter	PRE	_
aridas	aridus	ADJqua	Fem
natis	natis	NOM	_
podex	podex	NOM	_
uelut	uelut	ADVrel	_
crudae	crudus	ADJqua	Fem
bouis	bos	NOM	_

ut	ut	CONsub	_
Argonautas	argonautae	NOM	_
praeter	praeter	PRE	_
omnis	omnis	PROind	MascFem
candidum	candidus	ADJqua	MascNeut
Medea	medea	NOM	_
mirata	miror	VER	Fem
ducem	dux	NOM	_
ignota	ignotus	ADJqua	Neut
tauris	taurus	NOM	_
inligaturum	illigo	VER	MascNeut
iuga	iugum	NOM	_
perunxit	perungo	VER	_
hoc	hic	PROdem	MascNeut
Iasonem	iason	NOM	_
hoc	hic	PROdem	MascNeut
delibutis	delibuo	VER	Com
ulta	ulciscor	VER	Fem
donis	donum	NOM	_
paelicem	pellex	NOM	_
serpente	serpens	NOM	_
fugit	fugio	VER	_
alite	ales	ADJqua	Com

sectus	seco	VER	Masc
flagellis	flagellum	NOM	_
hic	hic	PROdem	Masc
triumuiralibus	triumuiralis	ADJqua	Com
praeconis	praeco	NOM	_
ad	ad	PRE	_
fastidium	fastidium	NOM	_
arat	aro	VER	_
Falerni	falernus	ADJqua	MascFem
mille	mille	ADJcar	_
fundi	fundus	NOM	_
iugera	iugerum	NOM	_
et	et	CONcoo	_
Appiam	appia	NOM	_
mannis	mannus	NOM	_
terit	tero	VER	_
sedilibus	sedile	NOM	_
-que	que	CONcoo	_
magnus	magnus	ADJqua	Masc
inprimis	imprimis	ADV	_
eques	eques	NOM	_
Othone	otho	NOM	_
contempto	contemno	VER	MascNeut
sedet	sedeo	VER	_

sub	sub	PRE	_
haec	hic	PROdem	Neut
puer	puer	NOM	_
iam	iam	ADV	_
non	non	ADVneg	_
ut	ut	ADVrel	_
ante	ante	ADV	_
mollibus	mollis	ADJqua	Com
lenire	lenio	VER	_
uerbis	uerbum	NOM	_
inpias	impius	ADJqua	Fem
sed	sed	CONcoo	_
dubius	dubius	ADJqua	Masc
unde	unde	ADVint	_
rumperet	rumpo	VER	_
silentium	silentium	NOM	_
misit	mitto	VER	_
Thyesteas	thyestus	ADJqua	Fem
preces	prex	NOM	_
uenena	uenenum	NOM	_
magnum	magnus	ADJqua	Neut
fas	fas	NOM	_
nefas	nefas	NOM	_
-que	que	CONcoo	_
non	non	ADVneg	_
ualent	ualeo	VER	_
conuertere	conuerto	VER	_
humanam	humanus	ADJqua	Fem
uicem	uicis	NOM	_

altera	alter	PROind	Fem
iam	iam	ADV	_
teritur	tero	VER	_
bellis	bellum	NOM	_
ciuilibus	ciuilis	ADJqua	Com
aetas	aetas	NOM	_
suis	suus	PROpos.ref	Com
et	et	CONcoo	_
ipsa	ipse	PROdem	Fem
Roma	roma	NOM	_
uiribus	uis	NOM	_
ruit	ruo	VER	_

cetera	cetera	NOM	_
mitte	mitto	VER	_
loqui	loquor	VER	_
deus	deus	NOM	_
haec	hic	PROdem	Neut
fortasse	fortasse	ADV	_
benigna	benignus	ADJqua	Neut
reducet	reduco	VER	_
in	in	PRE	_
sedem	sedes	NOM	_
uice	uicis	NOM	_

ureris	uro	VER	_
ipse	ipse	PROdem	Masc
miser	miser	ADJqua	Masc

nunc	nunc	ADV	_
et	et	CONcoo	_
Achaemenio	achaemenius	ADJqua	MascFem
perfundi	perfundo	VER	_
nardo	nardus	NOM	_
iuuat	iuuo	VER	_
et	et	CONcoo	_
fide	fides	NOM	_
Cyllenaea	cylleneus	ADJqua	Fem
leuare	leuo	VER	_
diris	dirus	ADJqua	Com
pectora	pectus	NOM	_
sollicitudinibus	sollicitudo	NOM	_
nobilis	nobilis	ADJqua	MascFem
ut	ut	ADVrel	_
grandi	grandis	ADJqua	Com
cecinit	cano	VER	_
Centaurus	centaurus	NOM	_
alumno	alumnus	NOM	_
inuicte	inuictus	ADJqua	Masc
mortalis	mortalis	ADJqua	MascFem
dea	dea	NOM	_
nate	natus	ADJqua	Masc
puer	puer	NOM	_
Thetide	thetis	NOM	_
te	tu	PROper	_
manet	maneo	VER	_
Assaraci	assaracus	NOM	_
tellus	tellus	NOM	_
quam	qui	PROrel	Fem
frigida	frigidus	ADJqua	Neut
parui	paruus	ADJqua	MascNeut
findunt	findo	VER	_
Scamandri	scamander	NOM	_
flumina	flumen	NOM	_
lubricus	lubricus	ADJqua	Masc
et	et	CONcoo	_
Simois	simois	NOM	_
unde	unde	ADVrel	_
tibi	tu	PROper	_
reditum	reditus	NOM	_
certo	certus	ADJqua	MascNeut
subtemine	subtemen	NOM	_
Parcae	parca	NOM	_
rupere	rumpo	VER	_
nec	nec	CONcoo	_
mater	mater	NOM	_
domum	domus	NOM	_
caerula	caeruleus	ADJqua	Fem
te	tu	PROper	_
reuehet	reueho	VER	_

mollis	mollis	ADJqua	MascFem
inertia	inertia	NOM	_
cur	cur	ADVint	_
tantam	tantus	PROdem	Fem
diffuderit	diffundo	VER	_
imis	inferus	ADJqua	Com
obliuionem	obliuio	NOM	_
sensibus	sensus	NOM	_
pocula	poculum	NOM	_
Lethaeos	lethaeus	ADJqua	Masc
ut	ut	ADVrel	_
si	si	CONsub	_
ducentia	duco	VER	Neut
somnos	somnus	NOM	_
arente	areo	VER	Com
fauce	faux	NOM	_
traxerim	traho	VER	_
candide	candidus	ADJqua	Masc
Maecenas	maecenas	NOM	_
occidis	occido	VER	_
saepe	saepe	ADV	_
rogando	rogo	VER	_
deus	deus	NOM	_
deus	deus	NOM	_
nam	nam	CONcoo	_
me	ego	PROper	_
uetat	ueto	VER	_
inceptos	incipio	VER	Masc
olim	olim	ADV	_
promissum	promitto	VER	MascNeut
carmen	carmen	NOM	_
iambos	iambus	NOM	_
ad	ad	PRE	_
umbilicum	umbilicus	NOM	_
adducere	adduco	VER	_

sic	sic	ADV	_
est	sum	VER	_
acerba	acerbus	ADJqua	Neut
fata	fatum	NOM	_
Romanos	romani	NOM	_
agunt	ago	VER	_
scelus	scelus	NOM	_
-que	que	CONcoo	_
fraternae	fraternus	ADJqua	Fem
necis	nex	NOM	_
ut	ut	CONsub	_
inmerentis	immerens	ADJqua	Com
fluxit	fluo	VER	_
in	in	PRE	_
terram	terra	NOM	_
Remi	remus	NOM	_
sacer	sacer	ADJqua	Masc
nepotibus	nepos	NOM	_
cruor	cruor	NOM	_

aut	aut	CONcoo	_
quid	quis	PROint	Neut
omnium	omnis	PROind	Com
uoltus	uultus	NOM	_
in	in	PRE	_
unum	unum	NOM	_
me	ego	PROper	_
truces	trux	ADJqua	MascFem

non	non	ADVneg	_
huc	huc	ADV	_
Argoo	argous	ADJqua	MascNeut
contendit	contendo	VER	_
remige	remex	NOM	_
pinus	pinus	NOM	_
neque	neque	CONcoo	_
inpudica	impudicus	ADJqua	Fem
Colchis	colchis	ADJqua	Fem
intulit	infero	VER	_
pedem	pes	NOM	_
non	non	ADVneg	_
huc	huc	ADV	_
Sidonii	sidonius	ADJqua	Masc
torserunt	torqueo	VER	_
cornua	cornu	NOM	_
nautae	nauta	NOM	_
laboriosa	laboriosus	ADJqua	Fem
nec	nec	CONcoo	_
cohors	cohors	NOM	_
Vlixei	ulixeus	NOM	_

tacent	taceo	VER	_
et	et	CONcoo	_
albus	albus	ADJqua	Masc
ora	os	NOM	_
pallor	pallor	NOM	_
inficit	inficio	VER	_
mentes	mens	NOM	_
-que	que	CONcoo	_
perculsae	percello	VER	Fem
stupent	stupeo	VER	_

quo	quo	ADVint	_
quo	quo	ADVint	_
scelesti	scelestus	ADJqua	Masc
ruitis	ruo	VER	_

quod	quod	CONcoo	_
ut	ut	CONsub	_
superbo	superbus	ADJqua	MascNeut
prouoces	prouoco	VER	_
ab	ab	PRE	_
inguine	inguen	NOM	_
ore	os	NOM	_
adlaborandum	allaboro	VER	Neut
est	sum	VER	_
tibi	tu	PROper	_

