token	lemma	pos	Gend
eligunt	eligo	VER	_
feras	fera	NOM	_
et	et	CONcoo	_
detracta	detraho	VER	Neut
uelamina	uelamen	NOM	_
spargunt	spargo	VER	_
maculis	macula	NOM	_
pellibus	pellis	NOM	_
-que	que	CONcoo	_
beluarum	belua	NOM	_
quas	qui	PROrel	Fem
exterior	exter	ADJqua	MascFem
Oceanus	oceanus	NOM	_
atque	atque	CONcoo	_
ignotum	ignotus	ADJqua	Neut
mare	mare	NOM	_
gignit	gigno	VER	_

abeunti	abeo	VER	Com
si	si	CONsub	_
quid	quis	PROind	Neut
poposcerit	posco	VER	_
concedere	concedo	VER	_
moris	mos	NOM	_
et	et	CONcoo	_
poscendi	posco	VER	_
inuicem	inuicem	ADV	_
eadem	idem	PROdem	Fem
facilitas	facilitas	NOM	_

sed	sed	CONcoo	_
et	et	CONcoo	_
de	de	PRE	_
reconciliandis	reconcilio	VER	Com
inuicem	inuicem	ADV	_
inimicis	inimicus	NOM	_
et	et	CONcoo	_
iungendis	iungo	VER	Com
affinitatibus	affinitas	NOM	_
et	et	CONcoo	_
asciscendis	ascisco	VER	Com
principibus	princeps	NOM	_
de	de	PRE	_
pace	pax	NOM	_
denique	denique	ADV	_
ac	ac	CONcoo	_
bello	bellum	NOM	_
plerumque	plerumque	ADV	_
in	in	PRE	_
conuiuiis	conuiuium	NOM	_
consultant	consulto	VER	_
tamquam	tamquam	CONsub	_
nullo	nullus	PROind	MascNeut
magis	magis	ADV	_
tempore	tempus	NOM	_
aut	aut	CONcoo	_
ad	ad	PRE	_
simplices	simplex	ADJmul	MascFem
cogitationes	cogitatio	NOM	_
pateat	pateo	VER	_
animus	animus	NOM	_
aut	aut	CONcoo	_
ad	ad	PRE	_
magnas	magnus	ADJqua	Fem
incalescat	incalesco	VER	_

ea	is	PROdem	Fem
uis	uis	NOM	_
numini	numen	NOM	_
nomen	nomen	NOM	_
Alcis	alcis	NOM	_

apud	apud	PRE	_
Nahanarualos	nahanaruali	NOM	_
antiquae	antiquus	ADJqua	Fem
religionis	religio	NOM	_
lucus	lucus	NOM	_
ostenditur	ostendo	VER	_

praesidet	praesideo	VER	_
sacerdos	sacerdos	NOM	_
muliebri	muliebris	ADJqua	Com
ornatu	ornatus	NOM	_
sed	sed	CONcoo	_
deos	deus	NOM	_
interpretatione	interpretatio	NOM	_
Romana	romanus	ADJqua	Fem
Castorem	castor	NOM	_
Pollucem	pollux	NOM	_
-que	que	CONcoo	_
memorant	memoro	VER	_

illuc	illuc	ADV	_
usque	usque	ADV	_
et	et	CONcoo	_
fama	fama	NOM	_
uera	uerus	ADJqua	Fem
tantum	tantum	ADV	_
natura	natura	NOM	_

dirimit	dirimo	VER	_
enim	enim	CONcoo	_
scindit	scindo	VER	_
-que	que	CONcoo	_
Suebiam	suebia	NOM	_
continuum	continuus	ADJqua	Neut
montium	mons	NOM	_
iugum	iugum	NOM	_
ultra	ultra	PRE	_
quod	qui	PROrel	Neut
plurimae	multus	ADJqua	Fem
gentes	gens	NOM	_
agunt	ago	VER	_
ex	ex	PRE	_
quibus	qui	PROrel	Com
latissime	late	ADV	_
patet	pateo	VER	_
Lugiorum	lugii	NOM	_
nomen	nomen	NOM	_
in	in	PRE	_
plures	multus	ADJqua	MascFem
ciuitates	ciuitas	NOM	_
diffusum	diffusus	ADJqua	Neut

nulla	nullus	PROind	Neut
simulacra	simulacrum	NOM	_
nullum	nullus	PROind	Neut
peregrinae	peregrinus	ADJqua	Fem
superstitionis	superstitio	NOM	_
uestigium	uestigium	NOM	_
ut	ut	ADVrel	_
fratres	frater	NOM	_
tamen	tamen	ADV	_
ut	ut	ADVrel	_
iuuenes	iuuenis	NOM	_
uenerantur	ueneror	VER	_

in	in	PRE	_
latere	latus	NOM	_
Chaucorum	chauci	NOM	_
Chattorum	chatti	NOM	_
-que	que	CONcoo	_
Cherusci	cherusci	NOM	_
nimiam	nimius	ADJqua	Fem
ac	ac	CONcoo	_
marcentem	marcens	ADJqua	MascFem
diu	diu	ADV	_
pacem	pax	NOM	_
illacessiti	illacessitus	ADJqua	Masc
nutrierunt	nutrio	VER	_
id	is	PROdem	Neut
-que	que	CONcoo	_
iucundius	iucundus	ADJqua	Neut
quam	quam	ADVrel	_
tutius	tutus	ADJqua	Neut
fuit	sum	VER	_
quia	quia	CONsub	_
inter	inter	PRE	_
impotentis	impotens	ADJqua	MascFem
et	et	CONcoo	_
ualidos	ualidus	ADJqua	Masc
falso	falso	ADV	_
quiescas	quiesco	VER	_
ubi	ubi	CONsub	_
manu	manus	NOM	_
agitur	ago	VER	_
modestia	modestia	NOM	_
ac	ac	CONcoo	_
probitas	probitas	NOM	_
nomina	nomen	NOM	_
superioris	superus	ADJqua	Com
sunt	sum	VER	_

Suionum	suiones	NOM	_
hinc	hinc	ADV	_
ciuitates	ciuitas	NOM	_
ipso	ipse	PROdem	MascNeut
in	in	PRE	_
Oceano	oceanus	NOM	_
praeter	praeter	PRE	_
uiros	uir	NOM	_
arma	arma	NOM	_
-que	que	CONcoo	_
classibus	classis	NOM	_
ualent	ualeo	VER	_

acies	acies	NOM	_
per	per	PRE	_
cuneos	cuneus	NOM	_
componitur	compono	VER	_

Suionibus	suiones	NOM	_
Sithonum	sithones	NOM	_
gentes	gens	NOM	_
continuantur	continuo	VER	_

equestrium	equester	ADJqua	Com
sane	sane	ADV	_
uirium	uis	NOM	_
id	is	PROdem	Neut
proprium	proprius	ADJqua	Neut
cito	cito	ADV	_
parare	paro	VER	_
uictoriam	uictoria	NOM	_
cito	cito	ADV	_
cedere	cedo	VER	_
uelocitas	uelocitas	NOM	_
iuxta	iuxta	PRE	_
formidinem	formido	NOM	_
cunctatio	cunctatio	NOM	_
propior	propior	ADJqua	MascFem
constantiae	constantia	NOM	_
est	sum	VER	_

uictus	uinco	VER	Masc
uoluntariam	uoluntarius	ADJqua	Fem
seruitutem	seruitus	NOM	_
adit	adeo	VER	_
quamuis	quamuis	CONsub	_
iuuenior	iuuenis	ADJqua	MascFem
quamuis	quamuis	CONsub	_
robustior	robustus	ADJqua	MascFem
alligari	alligo	VER	_
se	sui	PROref	_
ac	ac	CONcoo	_
uenire	ueneo	VER	_
patitur	patior	VER	_

ipse	ipse	PROdem	Masc
eorum	is	PROdem	MascNeut
opinionibus	opinio	NOM	_
accedo	accedo	VER	_
qui	qui	PROrel	Masc
Germaniae	germania	NOM	_
populos	populus	NOM	_
nullis	nullus	PROind	Com
aliis	alius	PROind	Com
aliarum	alius	PROind	Fem
nationum	natio	NOM	_
conubiis	connubium	NOM	_
infectos	inficio	VER	Masc
propriam	proprius	ADJqua	Fem
et	et	CONcoo	_
sinceram	sincerus	ADJqua	Fem
et	et	CONcoo	_
tantum	tantum	ADV	_
sui	sui	PROref	_
similem	similis	ADJqua	MascFem
gentem	gens	NOM	_
extitisse	exsto	VER	_
arbitrantur	arbitror	VER	_

contra	contra	ADV	_
Langobardos	langobardi	NOM	_
paucitas	paucitas	NOM	_
nobilitat	nobilito	VER	_
plurimis	multus	ADJqua	Com
ac	ac	CONcoo	_
ualentissimis	ualens	ADJqua	Com
nationibus	natio	NOM	_
cincti	cingo	VER	Masc
non	non	ADVneg	_
per	per	PRE	_
obsequium	obsequium	NOM	_
sed	sed	CONcoo	_
proeliis	proelium	NOM	_
ac	ac	CONcoo	_
periclitando	periclitor	VER	_
tuti	tutus	ADJqua	Masc
sunt	sum	VER	_

hic	hic	ADV	_
Suebiae	suebia	NOM	_
finis	finis	NOM	_

si	si	CONsub	_
ciuitas	ciuitas	NOM	_
in	in	PRE	_
qua	qui	PROrel	Fem
orti	orior	VER	Masc
longa	longus	ADJqua	Fem
pace	pax	NOM	_
et	et	CONcoo	_
otio	otium	NOM	_
torpeat	torpeo	VER	_
plerique	plerique	NOM	_
nobilium	nobilis	ADJqua	Com
adulescentium	adolescens	NOM	_
petunt	peto	VER	_
ultro	ultro	ADV	_
eas	is	PROdem	Fem
nationes	natio	NOM	_
quae	qui	PROrel	Fem
tum	tum	ADV	_
bellum	bellum	NOM	_
aliquod	aliquis	PROind	Neut
gerunt	gero	VER	_
quia	quia	CONsub	_
et	et	CONcoo	_
ingrata	ingratus	ADJqua	Fem
genti	gens	NOM	_
quies	quies	NOM	_
et	et	CONcoo	_
facilius	facile	ADV	_
inter	inter	PRE	_
ancipitia	anceps	NOM	_
clarescunt	claresco	VER	_
magnum	magnus	ADJqua	MascNeut
-que	que	CONcoo	_
comitatum	comitatus	NOM	_
non	non	ADVneg	_
nisi	nisi	CONsub	_
ui	uis	NOM	_
bello	bellum	NOM	_
-que	que	CONcoo	_
tueare	tueor	VER	_
exigunt	exigo	VER	_
enim	enim	CONcoo	_
principis	princeps	NOM	_
sui	suus	PROpos.ref	MascNeut
liberalitate	liberalitas	NOM	_
illum	ille	PROdem	Masc
bellatorem	bellator	NOM	_
equum	equus	NOM	_
illam	ille	PROdem	Fem
cruentam	cruentus	ADJqua	Fem
uictricem	uictrix	NOM	_
-que	que	CONcoo	_
frameam	framea	NOM	_
nam	nam	CONcoo	_
epulae	epulae	NOM	_
et	et	CONcoo	_
quamquam	quamquam	ADVrel	_
incompti	incomptus	ADJqua	Masc
largi	largus	ADJqua	Masc
tamen	tamen	ADV	_
apparatus	apparatus	NOM	_
pro	pro	PRE	_
stipendio	stipendium	NOM	_
cedunt	cedo	VER	_

terra	terra	NOM	_
etsi	etsi	CONsub	_
aliquanto	aliquanto	ADV	_
specie	species	NOM	_
differt	differo	VER	_
in	in	PRE	_
uniuersum	uniuersum	NOM	_
tamen	tamen	ADV	_
aut	aut	CONcoo	_
siluis	silua	NOM	_
horrida	horridus	ADJqua	Fem
aut	aut	CONcoo	_
paludibus	palus	NOM	_
foeda	foedus	ADJqua	Fem
humidior	humidus	ADJqua	MascFem
qua	qua	ADVrel	_
Gallias	gallia	NOM	_
uentosior	uentosus	ADJqua	MascFem
qua	qua	ADVrel	_
Noricum	noricum	NOM	_
ac	ac	CONcoo	_
Pannoniam	pannonia	NOM	_
aspicit	aspicio	VER	_
satis	sata	NOM	_
ferax	ferax	ADJqua	Com
frugiferarum	frugifer	ADJqua	Fem
arborum	arbor	NOM	_
impatiens	impatiens	ADJqua	Com
pecorum	pecus	NOM	_
fecunda	fecundus	ADJqua	Fem
sed	sed	CONcoo	_
plerumque	plerumque	ADV	_
improcera	improcerus	ADJqua	Fem

non	non	ADVneg	_
numerauerim	numero	VER	_
inter	inter	PRE	_
Germaniae	germania	NOM	_
populos	populus	NOM	_
quamquam	quamquam	CONsub	_
trans	trans	PRE	_
Rhenum	rhenus	NOM	_
Danuuium	danuuius	NOM	_
-que	que	CONcoo	_
consederint	consido	VER	_
eos	is	PROdem	Masc
qui	qui	PROrel	Masc
decumates	decumates	ADJqua	MascFem
agros	ager	NOM	_
exercent	exerceo	VER	_
leuissimus	leuis	ADJqua	Masc
quisque	quisque	PROind	Masc
Gallorum	galli	NOM	_
et	et	CONcoo	_
inopia	inopia	NOM	_
audax	audax	ADJqua	Com
dubiae	dubius	ADJqua	Fem
possessionis	possessio	NOM	_
solum	solum	NOM	_
occupauere	occupo	VER	_
mox	mox	ADV	_
limite	limes	NOM	_
acto	ago	VER	MascNeut
promotis	promoueo	VER	Com
-que	que	CONcoo	_
praesidiis	praesidium	NOM	_
sinus	sinus	NOM	_
imperii	imperium	NOM	_
et	et	CONcoo	_
pars	pars	NOM	_
prouinciae	prouincia	NOM	_
habentur	habeo	VER	_

ita	ita	ADV	_
sede	sedes	NOM	_
finibus	finis	NOM	_
-que	que	CONcoo	_
in	in	PRE	_
sua	suus	PROpos.ref	Fem
ripa	ripa	NOM	_
mente	mens	NOM	_
animo	animus	NOM	_
-que	que	CONcoo	_
nobis	nos	PROper	_
-cum	cum	PRE	_
agunt	ago	VER	_
cetera	cetera	NOM	_
similes	similis	ADJqua	MascNeut
Batauis	bataui	NOM	_
nisi	nisi	CONsub	_
quod	quod	CONsub	_
ipso	ipse	PROdem	MascNeut
adhuc	adhuc	ADV	_
terrae	terra	NOM	_
suae	suus	PROpos.ref	Fem
solo	solum	NOM	_
et	et	CONcoo	_
caelo	caelum	NOM	_
acrius	acriter	ADV	_
animantur	animo	VER	_

quaedam	quidam	PROind	Neut
loca	locus	NOM	_
diligentius	diligenter	ADV	_
illinunt	illino	VER	_
terra	terra	NOM	_
ita	ita	ADV	_
pura	purus	ADJqua	Fem
ac	ac	CONcoo	_
splendente	splendeo	VER	Com
ut	ut	CONsub	_
picturam	pictura	NOM	_
ac	ac	CONcoo	_
liniamenta	lineamentum	NOM	_
colorum	color	NOM	_
imitetur	imitor	VER	_

conuictibus	conuictus	NOM	_
et	et	CONcoo	_
hospitiis	hospitium	NOM	_
non	non	ADVneg	_
alia	alius	PROind	Fem
gens	gens	NOM	_
effusius	effuse	ADV	_
indulget	indulgeo	VER	_

fecundiora	fecundus	ADJqua	Neut
igitur	igitur	CONcoo	_
nemora	nemus	NOM	_
lucos	lucus	NOM	_
-que	que	CONcoo	_
sicut	sicut	ADVrel	_
Orientis	oriens	NOM	_
secretis	secretum	NOM	_
ubi	ubi	ADVrel	_
tura	tus	NOM	_
balsama	balsamum	NOM	_
-que	que	CONcoo	_
sudantur	sudo	VER	_
ita	ita	ADV	_
Occidentis	occidens	NOM	_
insulis	insula	NOM	_
terris	terra	NOM	_
-que	que	CONcoo	_
inesse	insum	VER	_
crediderim	credo	VER	_
quae	qui	PROrel	Neut
uicini	uicinus	ADJqua	MascNeut
solis	sol	NOM	_
radiis	radius	NOM	_
expressa	exprimo	VER	Neut
atque	atque	CONcoo	_
liquentia	liqueo	VER	Neut
in	in	PRE	_
proximum	propior	ADJqua	MascNeut
mare	mare	NOM	_
labuntur	labor	VER	_
ac	ac	CONcoo	_
ui	uis	NOM	_
tempestatum	tempestas	NOM	_
in	in	PRE	_
aduersa	aduersus	ADJqua	Neut
litora	litus	NOM	_
exundant	exundo	VER	_

nam	nam	CONcoo	_
prope	prope	ADV	_
soli	solus	PROind	Masc
barbarorum	barbarus	NOM	_
singulis	singulus	ADJdis	Com
uxoribus	uxor	NOM	_
contenti	contentus	ADJqua	Masc
sunt	sum	VER	_
exceptis	excipio	VER	Com
admodum	admodum	ADV	_
paucis	pauci	NOM	_
qui	qui	PROrel	Masc
non	non	ADVneg	_
libidine	libido	NOM	_
sed	sed	CONcoo	_
ob	ob	PRE	_
nobilitatem	nobilitas	NOM	_
plurimis	multus	ADJqua	Com
nuptiis	nuptiae	NOM	_
ambiuntur	ambio	VER	_

hi	hic	PROdem	Masc
cuique	quisque	PROind	Com
sanctissimi	sanctus	ADJqua	Masc
testes	testis	NOM	_
hi	hic	PROdem	Masc
maximi	magnus	ADJqua	Masc
laudatores	laudator	NOM	_
ad	ad	PRE	_
matres	mater	NOM	_
ad	ad	PRE	_
coniuges	coniux	NOM	_
uulnera	uulnus	NOM	_
ferunt	fero	VER	_
nec	nec	CONcoo	_
illae	ille	PROdem	Fem
numerare	numero	VER	_
aut	aut	CONcoo	_
exigere	exigo	VER	_
plagas	plaga	NOM	_
pauent	paueo	VER	_
cibos	cibus	NOM	_
-que	que	CONcoo	_
et	et	CONcoo	_
hortamina	hortamen	NOM	_
pugnantibus	pugno	VER	Com
gestant	gesto	VER	_

ipsis	ipse	PROdem	Com
in	in	PRE	_
nullo	nullus	PROind	MascNeut
usu	usus	NOM	_
rude	rudis	ADJqua	Neut
legitur	lego	VER	_
informe	informis	ADJqua	Neut
perfertur	perfero	VER	_
pretium	pretium	NOM	_
-que	que	CONcoo	_
mirantes	miror	VER	MascFem
accipiunt	accipio	VER	_

inter	inter	PRE	_
familiam	familia	NOM	_
et	et	CONcoo	_
penates	penates	NOM	_
et	et	CONcoo	_
iura	ius	NOM	_
successionum	successio	NOM	_
equi	equus	NOM	_
traduntur	trado	VER	_
excipit	excipio	VER	_
filius	filius	NOM	_
non	non	ADVneg	_
ut	ut	ADVrel	_
cetera	cetera	NOM	_
maximus	magnus	ADJqua	Masc
natu	natu	NOM	_
sed	sed	CONcoo	_
prout	prout	ADVrel	_
ferox	ferox	ADJqua	Com
bello	bellum	NOM	_
et	et	CONcoo	_
melior	bonus	ADJqua	MascFem

crebrae	creber	ADJqua	Fem
ut	ut	ADVrel	_
inter	inter	PRE	_
uinolentos	uinolentus	NOM	_
rixae	rixa	NOM	_
raro	raro	ADV	_
conuiciis	conuicium	NOM	_
saepius	saepe	ADV	_
caede	caedes	NOM	_
et	et	CONcoo	_
uulneribus	uulnus	NOM	_
transiguntur	transigo	VER	_

lamenta	lamenta	NOM	_
ac	ac	CONcoo	_
lacrimas	lacrima	NOM	_
cito	cito	ADV	_
dolorem	dolor	NOM	_
et	et	CONcoo	_
tristitiam	tristitia	NOM	_
tarde	tarde	ADV	_
ponunt	pono	VER	_

ceterum	ceterum	ADV	_
neque	neque	CONcoo	_
animaduertere	animaduerto	VER	_
neque	neque	CONcoo	_
uincire	uincio	VER	_
ne	ne	ADVneg	_
uerberare	uerbero	VER	_
quidem	quidem	ADV	_
nisi	nisi	CONsub	_
sacerdotibus	sacerdos	NOM	_
permissum	permitto	VER	Neut
non	non	ADVneg	_
quasi	quasi	ADVrel	_
in	in	PRE	_
poenam	poena	NOM	_
nec	nec	CONcoo	_
ducis	dux	NOM	_
iussu	iussus	NOM	_
sed	sed	CONcoo	_
uelut	uelut	ADVrel	_
deo	deus	NOM	_
imperante	impero	VER	Com
quem	qui	PROrel	Masc
adesse	assum	VER	_
bellantibus	bello	VER	Com
credunt	credo	VER	_

Peucinorum	peucini	NOM	_
Venethorum	uenethi	NOM	_
-que	que	CONcoo	_
et	et	CONcoo	_
Fennorum	fenni	NOM	_
nationes	natio	NOM	_
Germanis	germani	NOM	_
an	an	ADVint	_
Sarmatis	sarmatae	NOM	_
ascribam	ascribo	VER	_
dubito	dubito	VER	_

struem	strues	NOM	_
rogi	rogus	NOM	_
nec	nec	CONcoo	_
uestibus	uestis	NOM	_
nec	nec	CONcoo	_
odoribus	odor	NOM	_
cumulant	cumulo	VER	_
sua	suus	PROpos.ref	Neut
cuique	quisque	PROind	Com
arma	arma	NOM	_
quorundam	quidam	PROind	MascNeut
igni	ignis	NOM	_
et	et	ADV	_
equus	equus	NOM	_
adicitur	adicio	VER	_

sed	sed	CONcoo	_
et	et	ADV	_
mare	mare	NOM	_
scrutantur	scrutor	VER	_
ac	ac	CONcoo	_
soli	solus	PROind	Masc
omnium	omnis	PROind	Com
sucinum	sucinum	NOM	_
quod	qui	PROrel	Neut
ipsi	ipse	PROdem	Masc
glesum	glesum	NOM	_
uocant	uoco	VER	_
inter	inter	PRE	_
uada	uadum	NOM	_
atque	atque	CONcoo	_
in	in	PRE	_
ipso	ipse	PROdem	MascNeut
litore	litus	NOM	_
legunt	lego	VER	_

ceterum	ceterum	ADV	_
seruis	seruus	NOM	_
non	non	ADVneg	_
in	in	PRE	_
nostrum	noster	PROpos	MascNeut
morem	mos	NOM	_
descriptis	describo	VER	Com
per	per	PRE	_
familiam	familia	NOM	_
ministeriis	ministerium	NOM	_
utuntur	utor	VER	_
suam	suus	PROpos.ref	Fem
quisque	quisque	PROind	Masc
sedem	sedes	NOM	_
suos	suus	PROpos.ref	Masc
penates	penates	NOM	_
regit	rego	VER	_

nec	nec	CONcoo	_
arma	arma	NOM	_
ut	ut	ADVrel	_
apud	apud	PRE	_
ceteros	ceterus	ADJqua	Masc
Germanos	germani	NOM	_
in	in	PRE	_
promiscuo	promiscuum	NOM	_
sed	sed	CONcoo	_
clausa	claudo	VER	Neut
sub	sub	PRE	_
custode	custos	NOM	_
et	et	CONcoo	_
quidem	quidem	ADV	_
seruo	seruus	NOM	_
quia	quia	CONsub	_
subitos	subitus	ADJqua	Masc
hostium	hostis	NOM	_
incursus	incursus	NOM	_
prohibet	prohibeo	VER	_
Oceanus	oceanus	NOM	_
otiosae	otiosus	ADJqua	Fem
porro	porro	ADV	_
armatorum	armati	NOM	_
manus	manus	NOM	_
facile	facile	ADV	_
lasciuiunt	lasciuio	VER	_
enimuero	enimuero	ADV	_
neque	neque	CONcoo	_
nobilem	nobilis	NOM	_
neque	neque	CONcoo	_
ingenuum	ingenuus	ADJqua	MascNeut
ne	ne	ADVneg	_
libertinum	libertinus	NOM	_
quidem	quidem	ADV	_
armis	arma	NOM	_
praeponere	praepono	VER	_
regia	regius	ADJqua	Fem
utilitas	utilitas	NOM	_
est	sum	VER	_

cetera	cetera	NOM	_
similes	similis	ADJqua	MascFem
uno	unum	NOM	_
differunt	differo	VER	_
quod	quod	CONsub	_
femina	femina	NOM	_
dominatur	dominor	VER	_
in	in	PRE	_
tantum	tantum	PROdem	MascNeut
non	non	ADVneg	_
modo	modo	ADV	_
a	ab	PRE	_
libertate	libertas	NOM	_
sed	sed	CONcoo	_
etiam	etiam	ADV	_
a	ab	PRE	_
seruitute	seruitus	NOM	_
degenerant	degenero	VER	_

raro	raro	ADV	_
armis	arma	NOM	_
nostris	noster	PROpos	Com
saepius	saepe	ADV	_
pecunia	pecunia	NOM	_
iuuantur	iuuo	VER	_
nec	nec	CONcoo	_
minus	parum	ADV	_
ualent	ualeo	VER	_

Rhenus	rhenus	NOM	_
Raeticarum	raeticus	ADJqua	Fem
Alpium	alpes	NOM	_
inaccesso	inaccessus	ADJqua	MascNeut
ac	ac	CONcoo	_
praecipiti	praeceps	ADJqua	Com
uertice	uertex	NOM	_
ortus	orior	VER	Masc
modico	modicus	ADJqua	MascNeut
flexu	flexus	NOM	_
in	in	PRE	_
occidentem	occidens	NOM	_
uersus	uerto	VER	Masc
septentrionali	septentrionalis	ADJqua	Com
Oceano	oceanus	NOM	_
miscetur	misceo	VER	_

inde	inde	ADV	_
otium	otium	NOM	_
donec	donec	CONsub	_
occasione	occasio	NOM	_
discordiae	discordia	NOM	_
nostrae	noster	PROpos	Fem
et	et	CONcoo	_
ciuilium	ciuilis	ADJqua	Com
armorum	arma	NOM	_
expugnatis	expugno	VER	Com
legionum	legio	NOM	_
hibernis	hiberna	NOM	_
etiam	etiam	ADV	_
Gallias	gallia	NOM	_
affectauere	affecto	VER	_
ac	ac	CONcoo	_
rursus	rursus	ADV	_
pulsi	pello	VER	Masc
inde	inde	ADV	_
proximis	propior	ADJqua	Com
temporibus	tempus	NOM	_
triumphati	triumpho	VER	Masc
magis	magis	ADV	_
quam	quam	ADVrel	_
uicti	uinco	VER	Masc

est	sum	VER	_
in	in	PRE	_
insula	insula	NOM	_
Oceani	oceanus	NOM	_
castum	castus	ADJqua	Neut
nemus	nemus	NOM	_
dicatum	dico	VER	Neut
-que	que	CONcoo	_
in	in	PRE	_
eo	is	PROdem	MascNeut
uehiculum	uehiculum	NOM	_
ueste	uestis	NOM	_
contectum	contego	VER	Neut
attingere	attingo	VER	_
uni	unus	ADJcar	Com
sacerdoti	sacerdos	NOM	_
concessum	concedo	VER	MascNeut

nec	nec	CONcoo	_
regibus	rex	NOM	_
infinita	infinitus	ADJqua	Fem
aut	aut	CONcoo	_
libera	liber	ADJqua	Fem
potestas	potestas	NOM	_
et	et	CONcoo	_
duces	dux	NOM	_
exemplo	exemplum	NOM	_
potius	potius	ADV	_
quam	quam	ADVrel	_
imperio	imperium	NOM	_
si	si	CONsub	_
prompti	promptus	ADJqua	Masc
si	si	CONsub	_
conspicui	conspicuus	ADJqua	Masc
si	si	CONsub	_
ante	ante	PRE	_
aciem	acies	NOM	_
agant	ago	VER	_
admiratione	admiratio	NOM	_
praesunt	praesum	VER	_

et	et	ADV	_
aliis	alius	PROind	Com
Germanorum	germani	NOM	_
populis	populus	NOM	_
usurpatum	usurpo	VER	Neut
raro	raro	ADV	_
et	et	CONcoo	_
priuata	priuatus	ADJqua	Fem
cuiusque	quisque	PROind	Com
audentia	audentia	NOM	_
apud	apud	PRE	_
Chattos	chatti	NOM	_
in	in	PRE	_
consensum	consensus	NOM	_
uertit	uerto	VER	_
ut	ut	CONsub	_
primum	primum	ADJadv.ord	_
adoleuerint	adolesco	VER	_
crinem	crinis	NOM	_
barbam	barba	NOM	_
-que	que	CONcoo	_
submittere	submitto	VER	_
nec	nec	CONcoo	_
nisi	nisi	CONsub	_
hoste	hostis	NOM	_
caeso	caedo	VER	MascNeut
exuere	exuo	VER	_
uotiuum	uotiuum	NOM	_
obligatum	obligo	VER	MascNeut
-que	que	CONcoo	_
uirtuti	uirtus	NOM	_
oris	os	NOM	_
habitum	habitus	NOM	_

argentum	argentum	NOM	_
-que	que	CONcoo	_
magis	magis	ADV	_
quam	quam	ADVrel	_
aurum	aurum	NOM	_
sequuntur	sequor	VER	_
nulla	nullus	PROind	Fem
affectione	affectatio	NOM	_
animi	animus	NOM	_
sed	sed	CONcoo	_
quia	quia	CONsub	_
numerus	numerus	NOM	_
argenteorum	argenteus	NOM	_
facilior	facilis	ADJqua	MascFem
usui	usus	NOM	_
est	sum	VER	_
promiscua	promiscuus	ADJqua	Neut
ac	ac	CONcoo	_
uilia	uilis	ADJqua	Neut
mercantibus	mercor	VER	Com

mox	mox	ADV	_
uehiculum	uehiculum	NOM	_
et	et	CONcoo	_
uestes	uestis	NOM	_
et	et	CONcoo	_
si	si	CONsub	_
credere	credo	VER	_
uelis	uolo	VER	_
numen	numen	NOM	_
ipsum	ipse	PROdem	Neut
secreto	secretus	ADJqua	MascNeut
lacu	lacus	NOM	_
abluitur	abluo	VER	_

super	super	PRE	_
sexaginta	sexaginta	ADJcar	_
milia	mille	ADJcar	Neut
non	non	ADVneg	_
armis	arma	NOM	_
telis	telum	NOM	_
-que	que	CONcoo	_
Romanis	romanus	ADJqua	Com
sed	sed	CONcoo	_
quod	qui	PROrel	Neut
magnificentius	magnificus	ADJqua	Neut
est	sum	VER	_
oblectationi	oblectatio	NOM	_
oculis	oculus	NOM	_
-que	que	CONcoo	_
ceciderunt	cado	VER	_

reges	rex	NOM	_
ex	ex	PRE	_
nobilitate	nobilitas	NOM	_
duces	dux	NOM	_
ex	ex	PRE	_
uirtute	uirtus	NOM	_
sumunt	sumo	VER	_

memoriae	memoria	NOM	_
proditur	prodo	VER	_
quasdam	quidam	PROind	Fem
acies	acies	NOM	_
inclinatas	inclinatus	ADJqua	Fem
iam	iam	ADV	_
et	et	CONcoo	_
labantes	labo	VER	MascFem
a	ab	PRE	_
feminis	femina	NOM	_
restitutas	restituo	VER	Fem
constantia	constantia	NOM	_
precum	prex	NOM	_
et	et	CONcoo	_
obiectu	obiectus	NOM	_
pectorum	pectus	NOM	_
et	et	CONcoo	_
monstrata	monstro	VER	Fem
cominus	cominus	ADV	_
captiuitate	captiuitas	NOM	_
quam	qui	PROrel	Fem
longe	longe	ADV	_
impatientius	impatienter	ADV	_
feminarum	femina	NOM	_
suarum	suus	PROpos.ref	Fem
nomine	nomen	NOM	_
timent	timeo	VER	_
adeo	adeo	ADV	_
ut	ut	CONsub	_
efficacius	efficaciter	ADV	_
obligentur	obligo	VER	_
animi	animus	NOM	_
ciuitatum	ciuitas	NOM	_
quibus	qui	PROrel	Com
inter	inter	PRE	_
obsides	obses	NOM	_
puellae	puella	NOM	_
quoque	quoque	ADV	_
nobiles	nobilis	ADJqua	MascFem
imperantur	impero	VER	_

ei	is	PROdem	Com
filium	filius	NOM	_
Mannum	mannus	NOM	_
originem	origo	NOM	_
gentis	gens	NOM	_
conditorem	conditor	NOM	_
-que	que	CONcoo	_
Manno	mannus	NOM	_
tris	tres	ADJcar	MascFem
filios	filius	NOM	_
assignant	assigno	VER	_
e	ex	PRE	_
quorum	qui	PROrel	MascNeut
nominibus	nomen	NOM	_
proximi	propior	ADJqua	Masc
Oceano	oceanus	NOM	_
Ingaeuones	ingaeuones	NOM	_
medii	medius	ADJqua	Masc
Herminones	herminones	NOM	_
ceteri	ceteri	NOM	_
Istaeuones	istaeuones	NOM	_
uocentur	uoco	VER	_

equi	equus	NOM	_
non	non	ADVneg	_
forma	forma	NOM	_
non	non	ADVneg	_
uelocitate	uelocitas	NOM	_
conspicui	conspicuus	ADJqua	Masc

deorum	deus	NOM	_
maxime	magis	ADV	_
Mercurium	mercurius	NOM	_
colunt	colo	VER	_
cui	qui	PROrel	Com
certis	certus	ADJqua	Com
diebus	dies	NOM	_
humanis	humanus	ADJqua	Com
quoque	quoque	ADV	_
hostiis	hostia	NOM	_
litare	lito	VER	_
fas	fas	NOM	_
habent	habeo	VER	_

si	si	CONsub	_
displicuit	displiceo	VER	_
sententia	sententia	NOM	_
fremitu	fremitus	NOM	_
aspernantur	aspernor	VER	_
sin	sin	CONsub	_
placuit	placeo	VER	_
frameas	framea	NOM	_
concutiunt	concutio	VER	_
honoratissimum	honoratus	ADJqua	Neut
assensus	assensus	NOM	_
genus	genus	NOM	_
est	sum	VER	_
armis	arma	NOM	_
laudare	laudo	VER	_

fuisse	sum	VER	_
apud	apud	PRE	_
eos	is	PROdem	Masc
et	et	ADV	_
Herculem	hercules	NOM	_
memorant	memoro	VER	_
primum	primus	ADJord	MascNeut
-que	que	CONcoo	_
omnium	omnis	PROind	Com
uirorum	uir	NOM	_
fortium	fortis	ADJqua	Com
ituri	eo	VER	Masc
in	in	PRE	_
proelia	proelium	NOM	_
canunt	cano	VER	_

arua	aruum	NOM	_
per	per	PRE	_
annos	annus	NOM	_
mutant	muto	VER	_
et	et	CONcoo	_
superest	supersum	VER	_
ager	ager	NOM	_

mox	mox	ADV	_
si	si	CONsub	_
publice	publice	ADV	_
consultetur	consulto	VER	_
sacerdos	sacerdos	NOM	_
ciuitatis	ciuitas	NOM	_
sin	sin	CONsub	_
priuatim	priuatim	ADV	_
ipse	ipse	PROdem	Masc
pater	pater	NOM	_
familiae	familia	NOM	_
precatus	precor	VER	Masc
deos	deus	NOM	_
caelum	caelum	NOM	_
-que	que	CONcoo	_
suspiciens	suspicio	VER	Com
ter	ter	ADJadv.mul	_
singulos	singulus	ADJdis	Masc
tollit	tollo	VER	_
sublatos	tollo	VER	Masc
secundum	secundum	PRE	_
impressam	imprimo	VER	Fem
ante	ante	ADV	_
notam	nota	NOM	_
interpretatur	interpretor	VER	_

locupletissimi	locuples	ADJqua	Masc
ueste	uestis	NOM	_
distinguuntur	distinguo	VER	_
non	non	ADVneg	_
fluitante	fluito	VER	Com
sicut	sicut	ADVrel	_
Sarmatae	sarmatae	NOM	_
ac	ac	CONcoo	_
Parthi	parthi	NOM	_
sed	sed	CONcoo	_
stricta	strictus	ADJqua	Fem
et	et	CONcoo	_
singulos	singulus	ADJdis	Masc
artus	artus	NOM	_
exprimente	exprimo	VER	Com

uetustissimos	uetustus	ADJqua	Masc
se	sui	PROref	_
nobilissimos	nobilis	ADJqua	Masc
-que	que	CONcoo	_
Sueborum	suebi	NOM	_
Semnones	semnones	NOM	_
memorant	memoro	VER	_
fides	fides	NOM	_
antiquitatis	antiquitas	NOM	_
religione	religio	NOM	_
firmatur	firmo	VER	_

ueteris	uetus	ADJqua	Com
-que	que	CONcoo	_
famae	fama	NOM	_
lata	latus	ADJqua	Neut
uestigia	uestigium	NOM	_
manent	maneo	VER	_
utraque	uterque	PROind	Fem
ripa	ripa	NOM	_
castra	castra	NOM	_
ac	ac	CONcoo	_
spatia	spatium	NOM	_
quorum	qui	PROrel	MascNeut
ambitu	ambitus	NOM	_
nunc	nunc	ADV	_
quoque	quoque	ADV	_
metiaris	metior	VER	_
molem	moles	NOM	_
manus	manus	NOM	_
-que	que	CONcoo	_
gentis	gens	NOM	_
et	et	CONcoo	_
tam	tam	ADV	_
magni	magnus	ADJqua	Masc
exitus	exitus	NOM	_
fidem	fides	NOM	_

si	si	CONsub	_
indulseris	indulgeo	VER	_
ebrietati	ebrietas	NOM	_
suggerendo	suggero	VER	_
quantum	quantum	ADVrel	_
concupiscunt	concupisco	VER	_
haud	haud	ADVneg	_
minus	parum	ADV	_
facile	facile	ADV	_
uitiis	uitium	NOM	_
quam	quam	ADVrel	_
armis	arma	NOM	_
uincentur	uinco	VER	_

scutum	scutum	NOM	_
reliquisse	relinquo	VER	_
praecipuum	praecipuus	ADJqua	Neut
flagitium	flagitium	NOM	_
nec	nec	CONcoo	_
aut	aut	CONcoo	_
sacris	sacrum	NOM	_
adesse	assum	VER	_
aut	aut	CONcoo	_
concilium	concilium	NOM	_
inire	ineo	VER	_
ignominioso	ignominiosus	ADJqua	Com
fas	fas	NOM	_
multi	multus	ADJqua	Masc
-que	que	CONcoo	_
superstites	superstes	ADJqua	Com
bellorum	bellum	NOM	_
infamiam	infamia	NOM	_
laqueo	laqueus	NOM	_
finierunt	finio	VER	_

sed	sed	CONcoo	_
nec	nec	ADVneg	_
uariare	uario	VER	_
gyros	gyrus	NOM	_
in	in	PRE	_
morem	mos	NOM	_
nostrum	noster	PROpos	MascNeut
docentur	doceo	VER	_
in	in	PRE	_
rectum	rectum	NOM	_
aut	aut	CONcoo	_
uno	unus	ADJcar	MascNeut
flexu	flexus	NOM	_
dextros	dexter	ADJqua	Masc
agunt	ago	VER	_
ita	ita	ADV	_
coniuncto	coniungo	VER	MascNeut
orbe	orbis	NOM	_
ut	ut	CONsub	_
nemo	nemo	PROind	_
posterior	posterus	ADJqua	MascFem
sit	sum	VER	_

hi	hic	PROdem	Masc
lusus	lusus	NOM	_
infantium	infans	NOM	_
haec	hic	PROdem	Fem
iuuenum	iuuenis	NOM	_
aemulatio	aemulatio	NOM	_
perseuerant	perseuero	VER	_
senes	senex	NOM	_

sororum	soror	NOM	_
filiis	filius	NOM	_
idem	idem	PROdem	MascNeut
apud	apud	PRE	_
auunculum	auunculus	NOM	_
qui	qui	PROrel	Masc
apud	apud	PRE	_
patrem	pater	NOM	_
honor	honor	NOM	_

est	sum	VER	_
et	et	ADV	_
alia	alius	PROind	Fem
obseruatio	obseruatio	NOM	_
auspiciorum	auspicium	NOM	_
qua	qui	PROrel	Fem
grauium	grauis	ADJqua	Com
bellorum	bellum	NOM	_
euentus	euentus	NOM	_
explorant	exploro	VER	_

mox	mox	ADV	_
nemo	nemo	PROind	_
temptauit	tento	VER	_
sanctius	sanctus	ADJqua	Neut
-que	que	CONcoo	_
ac	ac	CONcoo	_
reuerentius	reuerens	ADJqua	Neut
uisum	uideo	VER	Neut
de	de	PRE	_
actis	actum	NOM	_
deorum	deus	NOM	_
credere	credo	VER	_
quam	quam	ADVrel	_
scire	scio	VER	_

trans	trans	PRE	_
Lugios	lugii	NOM	_
Gotones	gotones	NOM	_
regnantur	regno	VER	_
paulo	paulo	ADV	_
iam	iam	ADV	_
adductius	adducte	ADV	_
quam	quam	ADVrel	_
ceterae	ceterus	ADJqua	Fem
Germanorum	germani	NOM	_
gentes	gens	NOM	_
nondum	nondum	ADVneg	_
tamen	tamen	ADV	_
supra	supra	PRE	_
libertatem	libertas	NOM	_

affectatur	affecto	VER	_
praecipue	praecipue	ADV	_
asperitas	asperitas	NOM	_
soni	sonus	NOM	_
et	et	CONcoo	_
fractum	fractus	ADJqua	Neut
murmur	murmur	NOM	_
obiectis	obicio	VER	Com
ad	ad	PRE	_
os	os	NOM	_
scutis	scutum	NOM	_
quo	quo	CONsub	_
plenior	plenus	ADJqua	MascFem
et	et	CONcoo	_
grauior	grauis	ADJqua	MascFem
uox	uox	NOM	_
repercussu	repercussus	NOM	_
intumescat	intumesco	VER	_

gaudent	gaudeo	VER	_
muneribus	munus	NOM	_
sed	sed	CONcoo	_
nec	nec	CONcoo	_
data	do	VER	Neut
imputant	imputo	VER	_
nec	nec	CONcoo	_
acceptis	accipio	VER	Com
obligantur	obligo	VER	_

dominum	dominus	NOM	_
ac	ac	CONsub	_
seruum	seruus	NOM	_
nullis	nullus	PROind	Com
educationis	educatio	NOM	_
deliciis	delicia	NOM	_
dignoscas	dignosco	VER	_
inter	inter	PRE	_
eadem	idem	PROdem	Neut
pecora	pecus	NOM	_
in	in	PRE	_
eadem	idem	PROdem	Fem
humo	humus	NOM	_
degunt	dego	VER	_
donec	donec	CONsub	_
aetas	aetas	NOM	_
separet	separo	VER	_
ingenuos	ingenuus	ADJqua	Masc
uirtus	uirtus	NOM	_
agnoscat	agnosco	VER	_

ipsum	ipse	PROdem	MascNeut
quin	quin	ADV	_
etiam	etiam	ADV	_
Oceanum	oceanus	NOM	_
illa	illa	ADV	_
temptauimus	tento	VER	_
et	et	ADV	_
superesse	supersum	VER	_
adhuc	adhuc	ADV	_
Herculis	hercules	NOM	_
columnas	columna	NOM	_
fama	fama	NOM	_
uulgauit	uulgo	VER	_
siue	siue	CONsub	_
adiit	adeo	VER	_
Hercules	hercules	NOM	_
seu	seu	CONsub	_
quicquid	quisquis	PROrel	Neut
ubique	ubique	ADV	_
magnificum	magnificus	ADJqua	Neut
est	sum	VER	_
in	in	PRE	_
claritatem	claritas	NOM	_
eius	is	PROdem	Com
referre	refero	VER	_
consensimus	consentio	VER	_

tegumen	tegimen	NOM	_
omnibus	omnis	PROind	Com
sagum	sagum	NOM	_
fibula	fibula	NOM	_
aut	aut	CONcoo	_
si	si	CONsub	_
desit	desum	VER	_
spina	spina	NOM	_
consertum	consero	VER	Neut
cetera	cetera	NOM	_
intecti	intectus	ADJqua	Masc
totos	totus	PROind	Masc
dies	dies	NOM	_
iuxta	iuxta	PRE	_
focum	focus	NOM	_
atque	atque	CONcoo	_
ignem	ignis	NOM	_
agunt	ago	VER	_

uidimus	uideo	VER	_
sub	sub	PRE	_
diuo	diuus	ADJqua	Masc
Vespasiano	uespasianus	NOM	_
Veledam	ueleda	NOM	_
diu	diu	ADV	_
apud	apud	PRE	_
plerosque	plerique	NOM	_
numinis	numen	NOM	_
loco	locus	NOM	_
habitam	habeo	VER	Fem
sed	sed	CONcoo	_
et	et	ADV	_
olim	olim	ADV	_
Albrunam	albruna	NOM	_
et	et	CONcoo	_
compluris	complures	ADJqua	MascFem
alias	alius	PROind	Fem
uenerati	ueneror	VER	Masc
non	non	ADVneg	_
adulatione	adulatio	NOM	_
nec	nec	CONcoo	_
tamquam	tamquam	CONsub	_
facerent	facio	VER	_
deas	dea	NOM	_

postera	posterus	ADJqua	Fem
die	dies	NOM	_
retractatur	retracto	VER	_
et	et	CONcoo	_
salua	saluus	ADJqua	Fem
utriusque	uterque	PROind	Com
temporis	tempus	NOM	_
ratio	ratio	NOM	_
est	sum	VER	_
deliberant	delibero	VER	_
dum	dum	CONsub	_
fingere	fingo	VER	_
nesciunt	nescio	VER	_
constituunt	constituo	VER	_
dum	dum	CONsub	_
errare	erro	VER	_
non	non	ADVneg	_
possunt	possum	VER	_

laboris	labor	NOM	_
atque	atque	CONcoo	_
operum	opus	NOM	_
non	non	ADVneg	_
eadem	idem	PROdem	Fem
patientia	patientia	NOM	_
minime	parum	ADV	_
-que	que	CONcoo	_
sitim	sitis	NOM	_
aestum	aestus	NOM	_
-que	que	CONcoo	_
tolerare	tolero	VER	_
frigora	frigus	NOM	_
atque	atque	CONcoo	_
inediam	inedia	NOM	_
caelo	caelum	NOM	_
solo	solum	NOM	_
-ue	ue	CONcoo	_
assueuerunt	assuesco	VER	_

ultra	ultra	PRE	_
hos	hic	PROdem	Masc
Chatti	chatti	NOM	_
initium	initium	NOM	_
sedis	sedes	NOM	_
ab	ab	PRE	_
Hercynio	hercynius	ADJqua	MascNeut
saltu	saltus	NOM	_
incohant	incoho	VER	_
non	non	ADVneg	_
ita	ita	ADV	_
effusis	effusus	ADJqua	Com
ac	ac	CONcoo	_
palustribus	paluster	ADJqua	Com
locis	locus	NOM	_
ut	ut	ADVrel	_
ceterae	ceterus	ADJqua	Fem
ciuitates	ciuitas	NOM	_
in	in	PRE	_
quas	qui	PROrel	Fem
Germania	germania	NOM	_
patescit	patesco	VER	_
durant	duro	VER	_
siquidem	siquidem	CONsub	_
colles	collis	NOM	_
paulatim	paulatim	ADV	_
rarescunt	raresco	VER	_
et	et	CONcoo	_
Chattos	chatti	NOM	_
suos	suus	PROpos.ref	Masc
saltus	saltus	NOM	_
Hercynius	hercynius	ADJqua	Masc
prosequitur	prosequor	VER	_
simulatque	simulatque	CONsub	_
deponit	depono	VER	_

Danuuius	danuuius	NOM	_
molli	mollis	ADJqua	Com
et	et	CONcoo	_
clementer	clementer	ADV	_
edito	editus	ADJqua	MascNeut
montis	mons	NOM	_
Abnobae	abnoba	NOM	_
iugo	iugum	NOM	_
effusus	effundo	VER	Masc
pluris	multus	ADJqua	MascFem
populos	populus	NOM	_
adit	adeo	VER	_
donec	donec	CONsub	_
in	in	PRE	_
Ponticum	ponticus	ADJqua	MascNeut
mare	mare	NOM	_
sex	sex	ADJcar	_
meatibus	meatus	NOM	_
erumpat	erumpo	VER	_
septimum	septimus	ADJord	Neut
os	os	NOM	_
paludibus	palus	NOM	_
hauritur	haurio	VER	_

suscipere	suscipio	VER	_
tam	tam	ADV	_
inimicitias	inimicitia	NOM	_
seu	seu	CONcoo	_
patris	pater	NOM	_
seu	seu	CONcoo	_
propinqui	propinquus	ADJqua	MascNeut
quam	quam	ADVrel	_
amicitias	amicitia	NOM	_
necesse	necesse	ADJqua	_
est	sum	VER	_
nec	nec	CONcoo	_
implacabiles	implacabilis	ADJqua	MascFem
durant	duro	VER	_
luitur	luo	VER	_
enim	enim	CONcoo	_
etiam	etiam	ADV	_
homicidium	homicidium	NOM	_
certo	certus	ADJqua	MascNeut
armentorum	armentum	NOM	_
ac	ac	CONcoo	_
pecorum	pecus	NOM	_
numero	numerus	NOM	_
recipit	recipio	VER	_
-que	que	CONcoo	_
satisfactionem	satisfactio	NOM	_
uniuersa	uniuersus	ADJqua	Fem
domus	domus	NOM	_
utiliter	utiliter	ADV	_
in	in	PRE	_
publicum	publicum	NOM	_
quia	quia	CONsub	_
periculosiores	periculosus	ADJqua	MascFem
sunt	sum	VER	_
inimicitiae	inimicitia	NOM	_
iuxta	iuxta	PRE	_
libertatem	libertas	NOM	_

licet	licet	VER	_
apud	apud	PRE	_
concilium	concilium	NOM	_
accusare	accuso	VER	_
quoque	quoque	ADV	_
et	et	CONcoo	_
discrimen	discrimen	NOM	_
capitis	caput	NOM	_
intendere	intendo	VER	_

Angriuarios	angriuarii	NOM	_
et	et	CONcoo	_
Chamauos	chamaui	NOM	_
a	ab	PRE	_
tergo	tergum	NOM	_
Dulgubini	dulgubini	NOM	_
et	et	CONcoo	_
Chasuarii	chasuarii	NOM	_
cludunt	cludo	VER	_
aliae	alius	PROind	Fem
-que	que	CONcoo	_
gentes	gens	NOM	_
haud	haud	ADVneg	_
perinde	perinde	ADV	_
memoratae	memoro	VER	Fem
a	ab	PRE	_
fronte	frons	NOM	_
Frisii	frisii	NOM	_
excipiunt	excipio	VER	_

iuxta	iuxta	PRE	_
Tencteros	tencteri	NOM	_
Bructeri	bructeri	NOM	_
olim	olim	ADV	_
occurrebant	occurro	VER	_
nunc	nunc	ADV	_
Chamauos	chamaui	NOM	_
et	et	CONcoo	_
Angriuarios	angriuarii	NOM	_
immigrasse	immigro	VER	_
narratur	narro	VER	_
pulsis	pello	VER	Com
Bructeris	bructeri	NOM	_
ac	ac	CONcoo	_
penitus	penitus	ADV	_
excisis	excido	VER	Com
uicinarum	uicinus	ADJqua	Fem
consensu	consensus	NOM	_
nationum	natio	NOM	_
seu	seu	CONcoo	_
superbiae	superbia	NOM	_
odio	odium	NOM	_
seu	seu	CONcoo	_
praedae	praeda	NOM	_
dulcedine	dulcedo	NOM	_
seu	seu	CONcoo	_
fauore	fauor	NOM	_
quodam	quidam	PROind	MascNeut
erga	erga	PRE	_
nos	nos	PROper	_
deorum	deus	NOM	_
nam	nam	CONcoo	_
ne	ne	ADVneg	_
proelii	proelium	NOM	_
inuidere	inuideo	VER	_

aduersus	aduersus	PRE	_
sitim	sitis	NOM	_
non	non	ADVneg	_
eadem	idem	PROdem	Fem
temperantia	temperantia	NOM	_

omne	omnis	PROind	Neut
robur	robur	NOM	_
in	in	PRE	_
pedite	pedes	NOM	_
quem	qui	PROrel	Masc
super	super	PRE	_
arma	arma	NOM	_
ferramentis	ferramentum	NOM	_
quoque	quoque	ADV	_
et	et	CONcoo	_
copiis	copia	NOM	_
onerant	onero	VER	_
alios	alius	PROind	Masc
ad	ad	PRE	_
proelium	proelium	NOM	_
ire	eo	VER	_
uideas	uideo	VER	_
Chattos	chatti	NOM	_
ad	ad	PRE	_
bellum	bellum	NOM	_

rari	rarus	ADJqua	Masc
gladiis	gladius	NOM	_
aut	aut	CONcoo	_
maioribus	magnus	ADJqua	Com
lanceis	lancea	NOM	_
utuntur	utor	VER	_
hastas	hasta	NOM	_
uel	uel	CONcoo	_
ipsorum	ipse	PROdem	MascNeut
uocabulo	uocabulum	NOM	_
frameas	framea	NOM	_
gerunt	gero	VER	_
angusto	angustus	ADJqua	MascNeut
et	et	CONcoo	_
breui	breuis	ADJqua	Com
ferro	ferrum	NOM	_
sed	sed	CONcoo	_
ita	ita	ADV	_
acri	acer	ADJqua	Com
et	et	CONcoo	_
ad	ad	PRE	_
usum	usus	NOM	_
habili	habilis	ADJqua	Com
ut	ut	CONsub	_
eodem	idem	PROdem	MascNeut
telo	telum	NOM	_
prout	prout	ADVrel	_
ratio	ratio	NOM	_
poscit	posco	VER	_
uel	uel	CONcoo	_
cominus	cominus	ADV	_
uel	uel	CONcoo	_
eminus	eminus	ADV	_
pugnent	pugno	VER	_

insigne	insigne	NOM	_
gentis	gens	NOM	_
obliquare	obliquo	VER	_
crinem	crinis	NOM	_
nodo	nodus	NOM	_
-que	que	CONcoo	_
substringere	substringo	VER	_
sic	sic	ADV	_
Suebi	suebi	NOM	_
a	ab	PRE	_
ceteris	ceterus	ADJqua	Com
Germanis	germani	NOM	_
sic	sic	ADV	_
Sueborum	suebi	NOM	_
ingenui	ingenuus	ADJqua	Masc
a	ab	PRE	_
seruis	seruus	NOM	_
separantur	separo	VER	_

rarus	rarus	ADJqua	Masc
ferri	ferrum	NOM	_
frequens	frequens	ADJqua	Com
fustium	fustis	NOM	_
usus	usus	NOM	_

quamquam	quamquam	ADVrel	_
seuera	seuerus	ADJqua	Neut
illic	illic	ADV	_
matrimonia	matrimonium	NOM	_
nec	nec	CONcoo	_
ullam	ullus	PROind	Fem
morum	mos	NOM	_
partem	pars	NOM	_
magis	magis	ADV	_
laudaueris	laudo	VER	_

omnes	omnis	PROind	MascFem
-que	que	CONcoo	_
hi	hic	PROdem	Masc
populi	populus	NOM	_
pauca	paucus	ADJqua	Neut
campestrium	campestria	NOM	_
ceterum	ceterum	ADV	_
saltus	saltus	NOM	_
et	et	CONcoo	_
uertices	uertex	NOM	_
montium	mons	NOM	_
insederunt	insideo	VER	_

in	in	PRE	_
haec	hic	PROdem	Neut
munera	munus	NOM	_
uxor	uxor	NOM	_
accipitur	accipio	VER	_
atque	atque	CONcoo	_
inuicem	inuicem	ADV	_
ipsa	ipse	PROdem	Fem
armorum	arma	NOM	_
aliquid	aliquis	PROind	Neut
uiro	uir	NOM	_
affert	affero	VER	_
hoc	hic	PROdem	Neut
maximum	magnus	ADJqua	MascNeut
uinculum	uinculum	NOM	_
haec	hic	PROdem	Neut
arcana	arcanus	ADJqua	Neut
sacra	sacrum	NOM	_
hos	hic	PROdem	Masc
coniugales	coniugalis	ADJqua	MascFem
deos	deus	NOM	_
arbitrantur	arbitror	VER	_

in	in	PRE	_
Hermunduris	hermunduri	NOM	_
Albis	albis	NOM	_
oritur	orior	VER	_
flumen	flumen	NOM	_
inclutum	inclutus	ADJqua	Neut
et	et	CONcoo	_
notum	notus	ADJqua	Neut
olim	olim	ADV	_
nunc	nunc	ADV	_
tantum	tantum	ADV	_
auditur	audio	VER	_

ex	ex	PRE	_
quo	qui	PROrel	MascNeut
si	si	CONsub	_
ad	ad	PRE	_
alterum	alter	PROind	MascNeut
imperatoris	imperator	NOM	_
Traiani	traianus	NOM	_
consulatum	consulatus	NOM	_
computemus	computo	VER	_
ducenti	ducenti	ADJcar	Masc
ferme	ferme	ADV	_
et	et	CONcoo	_
decem	decem	ADJcar	_
anni	annus	NOM	_
colliguntur	colligo	VER	_
tamdiu	tamdiu	ADV	_
Germania	germania	NOM	_
uincitur	uinco	VER	_

nec	nec	CONcoo	_
arare	aro	VER	_
terram	terra	NOM	_
aut	aut	CONcoo	_
exspectare	exspecto	VER	_
annum	annus	NOM	_
tam	tam	ADV	_
facile	facile	ADV	_
persuaseris	persuadeo	VER	_
quam	quam	ADVrel	_
uocare	uoco	VER	_
hostem	hostis	NOM	_
et	et	CONcoo	_
uulnera	uulnus	NOM	_
mereri	mereor	VER	_
pigrum	piger	ADJqua	Neut
quin	quin	ADV	_
immo	immo	ADV	_
et	et	CONcoo	_
iners	iners	ADJqua	Com
uidetur	uideo	VER	_
sudore	sudor	NOM	_
acquirere	acquiro	VER	_
quod	qui	PROrel	Neut
possis	possum	VER	_
sanguine	sanguis	NOM	_
parare	paro	VER	_

gerunt	gero	VER	_
et	et	ADV	_
ferarum	fera	NOM	_
pelles	pellis	NOM	_
proximi	propior	ADJqua	Masc
ripae	ripa	NOM	_
neglegenter	negligenter	ADV	_
ulteriores	ulterior	ADJqua	MascFem
exquisitius	exquisite	ADV	_
ut	ut	ADVrel	_
quibus	qui	PROrel	Com
nullus	nullus	PROind	Masc
per	per	PRE	_
commercia	commercium	NOM	_
cultus	cultus	NOM	_

aleam	alea	NOM	_
quod	qui	PROrel	Neut
mirere	miror	VER	_
sobrii	sobrius	ADJqua	Masc
inter	inter	PRE	_
seria	serius	ADJqua	Neut
exercent	exerceo	VER	_
tanta	tantus	PROdem	Fem
lucrandi	lucror	VER	_
perdendi	perdo	VER	_
-ue	ue	CONcoo	_
temeritate	temeritas	NOM	_
ut	ut	CONsub	_
cum	cum	CONsub	_
omnia	omnis	PROind	Neut
defecerunt	deficio	VER	_
extremo	exter	ADJqua	MascNeut
ac	ac	CONcoo	_
nouissimo	nouus	ADJqua	MascNeut
iactu	iactus	NOM	_
de	de	PRE	_
libertate	libertas	NOM	_
ac	ac	CONcoo	_
de	de	PRE	_
corpore	corpus	NOM	_
contendant	contendo	VER	_

quamquam	quamquam	ADVrel	_
Peucini	peucini	NOM	_
quos	qui	PROrel	Masc
quidam	quidam	PROind	Masc
Bastarnas	bastarnae	NOM	_
uocant	uoco	VER	_
sermone	sermo	NOM	_
cultu	cultus	NOM	_
sede	sedes	NOM	_
ac	ac	CONcoo	_
domiciliis	domicilium	NOM	_
ut	ut	ADVrel	_
Germani	germani	NOM	_
agunt	ago	VER	_

ne	ne	ADVneg	_
caementorum	caementum	NOM	_
quidem	quidem	ADV	_
apud	apud	PRE	_
illos	ille	PROdem	Masc
aut	aut	CONcoo	_
tegularum	tegula	NOM	_
usus	usus	NOM	_
materia	materia	NOM	_
ad	ad	PRE	_
omnia	omnis	PROind	Neut
utuntur	utor	VER	_
informi	informis	ADJqua	Com
et	et	CONcoo	_
citra	citra	PRE	_
speciem	species	NOM	_
aut	aut	CONcoo	_
delectationem	delectatio	NOM	_

de	de	PRE	_
minoribus	paruus	ADJqua	Com
rebus	res	NOM	_
principes	princeps	NOM	_
consultant	consulto	VER	_
de	de	PRE	_
maioribus	magnus	ADJqua	Com
omnes	omnis	PROind	MascFem
ita	ita	ADV	_
tamen	tamen	ADV	_
ut	ut	CONsub	_
ea	is	PROdem	Neut
quoque	quoque	ADV	_
quorum	qui	PROrel	MascNeut
penes	penes	PRE	_
plebem	plebs	NOM	_
arbitrium	arbitrium	NOM	_
est	sum	VER	_
apud	apud	PRE	_
principes	princeps	NOM	_
praetractentur	praetracto	VER	_

Germania	germania	NOM	_
omnis	omnis	PROind	MascFem
a	ab	PRE	_
Gallis	galli	NOM	_
Raetis	raeti	NOM	_
-que	que	CONcoo	_
et	et	CONcoo	_
Pannoniis	pannonii	NOM	_
Rheno	rhenus	NOM	_
et	et	CONcoo	_
Danuuio	danuuius	NOM	_
fluminibus	flumen	NOM	_
a	ab	PRE	_
Sarmatis	sarmatae	NOM	_
Dacis	daci	NOM	_
-que	que	CONcoo	_
mutuo	mutuus	ADJqua	MascNeut
metu	metus	NOM	_
aut	aut	CONcoo	_
montibus	mons	NOM	_
separatur	separo	VER	_
cetera	cetera	NOM	_
Oceanus	oceanus	NOM	_
ambit	ambio	VER	_
latos	latus	ADJqua	Masc
sinus	sinus	NOM	_
et	et	CONcoo	_
insularum	insula	NOM	_
inmensa	immensus	ADJqua	Neut
spatia	spatium	NOM	_
complectens	complector	VER	Com
nuper	nuper	ADV	_
cognitis	cognosco	VER	Com
quibusdam	quidam	PROind	Com
gentibus	gens	NOM	_
ac	ac	CONcoo	_
regibus	rex	NOM	_
quos	qui	PROrel	Masc
bellum	bellum	NOM	_
aperuit	aperio	VER	_

si	si	CONsub	_
forte	forte	ADV	_
prolapsus	prolabor	VER	Masc
attolli	attollo	VER	_
et	et	CONcoo	_
insurgere	insurgo	VER	_
haud	haud	ADVneg	_
licitum	licitus	ADJqua	Neut
per	per	PRE	_
humum	humus	NOM	_
euoluuntur	euoluo	VER	_

coeunt	coeo	VER	_
nisi	nisi	CONsub	_
quid	quis	PROind	Neut
fortuitum	fortuitus	ADJqua	Neut
et	et	CONcoo	_
subitum	subitus	ADJqua	Neut
incidit	incido	VER	_
certis	certus	ADJqua	Com
diebus	dies	NOM	_
cum	cum	CONsub	_
aut	aut	CONcoo	_
inchoatur	inchoo	VER	_
luna	luna	NOM	_
aut	aut	CONcoo	_
impletur	impleo	VER	_
nam	nam	CONcoo	_
agendis	ago	VER	Com
rebus	res	NOM	_
hoc	hic	PROdem	Neut
auspicatissimum	auspicatus	ADJqua	MascNeut
initium	initium	NOM	_
credunt	credo	VER	_

nec	nec	CONcoo	_
tamen	tamen	ADV	_
affirmauerim	affirmo	VER	_
nullam	nullus	PROind	Fem
Germaniae	germania	NOM	_
uenam	uena	NOM	_
argentum	argentum	NOM	_
aurum	aurum	NOM	_
-ue	ue	CONcoo	_
gignere	gigno	VER	_
quis	quis	PROint	MascFem
enim	enim	CONcoo	_
scrutatus	scrutor	VER	Masc

ceterum	ceterum	ADV	_
Harii	harii	NOM	_
super	super	PRE	_
uires	uis	NOM	_
quibus	qui	PROrel	Com
enumeratos	enumero	VER	Masc
paulo	paulo	ADV	_
ante	ante	ADV	_
populos	populus	NOM	_
antecedunt	antecedo	VER	_
truces	trux	ADJqua	MascFem
insitae	insitus	ADJqua	Fem
feritati	feritas	NOM	_
arte	ars	NOM	_
ac	ac	CONcoo	_
tempore	tempus	NOM	_
lenocinantur	lenocinor	VER	_
nigra	niger	ADJqua	Neut
scuta	scutum	NOM	_
tincta	tingo	VER	Neut
corpora	corpus	NOM	_
atras	ater	ADJqua	Fem
ad	ad	PRE	_
proelia	proelium	NOM	_
noctes	nox	NOM	_
legunt	lego	VER	_
ipsa	ipse	PROdem	Fem
-que	que	CONcoo	_
formidine	formido	NOM	_
atque	atque	CONcoo	_
umbra	umbra	NOM	_
feralis	feralis	ADJqua	Com
exercitus	exercitus	NOM	_
terrorem	terror	NOM	_
inferunt	infero	VER	_
nullo	nullus	PROind	MascNeut
hostium	hostis	NOM	_
sustinente	sustineo	VER	Com
nouum	nouus	ADJqua	MascNeut
ac	ac	CONcoo	_
uelut	uelut	ADVrel	_
infernum	infernus	ADJqua	MascNeut
aspectum	aspectus	NOM	_
nam	nam	CONcoo	_
primi	primus	ADJord	Masc
in	in	PRE	_
omnibus	omnis	PROind	Com
proeliis	proelium	NOM	_
oculi	oculus	NOM	_
uincuntur	uinco	VER	_

ceterum	ceterum	ADV	_
Germaniae	germania	NOM	_
uocabulum	uocabulum	NOM	_
recens	recens	ADJqua	Com
et	et	CONcoo	_
nuper	nuper	ADV	_
additum	addo	VER	MascNeut
quoniam	quoniam	CONsub	_
qui	qui	PROrel	Masc
primi	primus	ADJord	Masc
Rhenum	rhenus	NOM	_
transgressi	transgredior	VER	Masc
Gallos	galli	NOM	_
expulerint	expello	VER	_
ac	ac	CONcoo	_
nunc	nunc	ADV	_
Tungri	tungri	NOM	_
tunc	tunc	ADV	_
Germani	germani	NOM	_
uocati	uoco	VER	Masc
ita	ita	ADV	_
nationis	natio	NOM	_
nomen	nomen	NOM	_
non	non	ADVneg	_
gentis	gens	NOM	_
eualuisse	eualesco	VER	_
paulatim	paulatim	ADV	_
ut	ut	CONsub	_
omnes	omnis	PROind	MascFem
primum	primum	ADJadv.ord	_
a	ab	PRE	_
uictore	uictor	NOM	_
ob	ob	PRE	_
metum	metus	NOM	_
mox	mox	ADV	_
etiam	etiam	ADV	_
a	ab	PRE	_
se	sui	PROref	_
ipsis	ipse	PROdem	Com
inuento	inuenio	VER	MascNeut
nomine	nomen	NOM	_
Germani	germani	NOM	_
uocarentur	uoco	VER	_

solent	soleo	VER	_
et	et	ADV	_
subterraneos	subterraneus	ADJqua	Masc
specus	specus	NOM	_
aperire	aperio	VER	_
eos	is	PROdem	Masc
-que	que	CONcoo	_
multo	multus	ADJqua	MascNeut
insuper	insuper	ADV	_
fimo	fimus	NOM	_
onerant	onero	VER	_
suffugium	suffugium	NOM	_
hiemis	hiems	NOM	_
et	et	CONcoo	_
receptaculum	receptaculum	NOM	_
frugibus	frux	NOM	_
quia	quia	CONsub	_
rigorem	rigor	NOM	_
frigorum	frigus	NOM	_
eius	is	PROdem	Com
modi	modus	NOM	_
loci	locus	NOM	_
molliunt	mollio	VER	_
et	et	CONcoo	_
si	si	CONsub	_
quando	quando	ADV	_
hostis	hostis	NOM	_
aduenit	aduenio	VER	_
aperta	apertus	ADJqua	Neut
populatur	populor	VER	_
abdita	abdo	VER	Neut
autem	autem	CONcoo	_
et	et	CONcoo	_
defossa	defodio	VER	Neut
aut	aut	CONcoo	_
ignorantur	ignoro	VER	_
aut	aut	CONcoo	_
eo	is	PROdem	MascNeut
ipso	ipse	PROdem	MascNeut
fallunt	fallo	VER	_
quod	quod	CONsub	_
quaerenda	quaero	VER	Neut
sunt	sum	VER	_

colunt	colo	VER	_
discreti	discerno	VER	Masc
ac	ac	CONcoo	_
diuersi	diuersus	ADJqua	Masc
ut	ut	ADVrel	_
fons	fons	NOM	_
ut	ut	ADVrel	_
campus	campus	NOM	_
ut	ut	ADVrel	_
nemus	nemus	NOM	_
placuit	placeo	VER	_

ac	ac	CONcoo	_
primo	primo	ADJadv.ord	_
statim	statim	ADV	_
Chaucorum	chauci	NOM	_
gens	gens	NOM	_
quamquam	quamquam	CONsub	_
incipiat	incipio	VER	_
a	ab	PRE	_
Frisiis	frisii	NOM	_
ac	ac	CONcoo	_
partem	pars	NOM	_
litoris	litus	NOM	_
occupet	occupo	VER	_
omnium	omnis	PROind	Com
quas	qui	PROrel	Fem
exposui	expono	VER	_
gentium	gens	NOM	_
lateribus	latus	NOM	_
obtenditur	obtendo	VER	_
donec	donec	CONsub	_
in	in	PRE	_
Chattos	chatti	NOM	_
usque	usque	ADV	_
sinuetur	sinuo	VER	_

e	ex	PRE	_
quibus	qui	PROrel	Com
Marsigni	marsigni	NOM	_
et	et	CONcoo	_
Buri	buri	NOM	_
sermone	sermo	NOM	_
cultu	cultus	NOM	_
-que	que	CONcoo	_
Suebos	suebi	NOM	_
referunt	refero	VER	_
Cotinos	cotini	NOM	_
Gallica	gallicus	ADJqua	Fem
Osos	osi	NOM	_
Pannonica	pannonicus	ADJqua	Fem
lingua	lingua	NOM	_
coarguit	coarguo	VER	_
non	non	ADVneg	_
esse	sum	VER	_
Germanos	germani	NOM	_
et	et	CONcoo	_
quod	quod	CONsub	_
tributa	tributum	NOM	_
patiuntur	patior	VER	_

tum	tum	ADV	_
in	in	PRE	_
ipso	ipse	PROdem	MascNeut
concilio	concilium	NOM	_
uel	uel	CONcoo	_
principum	princeps	NOM	_
aliquis	aliquis	PROind	Masc
uel	uel	CONcoo	_
pater	pater	NOM	_
uel	uel	CONcoo	_
propinqui	propinquus	ADJqua	Masc
scuto	scutum	NOM	_
framea	framea	NOM	_
-que	que	CONcoo	_
iuuenem	iuuenis	NOM	_
ornant	orno	VER	_
haec	hic	PROdem	Fem
apud	apud	PRE	_
illos	ille	PROdem	Masc
toga	toga	NOM	_
hic	hic	PROdem	Masc
primus	primus	ADJord	Masc
iuuentae	iuuenta	NOM	_
honos	honor	NOM	_
ante	ante	PRE	_
hoc	hic	PROdem	Neut
domus	domus	NOM	_
pars	pars	NOM	_
uidentur	uideo	VER	_
mox	mox	ADV	_
reipublicae	respublica	NOM	_
insignis	insignis	ADJqua	MascFem
nobilitas	nobilitas	NOM	_
aut	aut	CONcoo	_
magna	magnus	ADJqua	Neut
patrum	pater	NOM	_
merita	meritum	NOM	_
principis	princeps	NOM	_
dignationem	dignatio	NOM	_
etiam	etiam	ADV	_
adulescentulis	adolescentulus	NOM	_
assignant	assigno	VER	_
ceteri	ceteri	NOM	_
robustioribus	robustus	ADJqua	Com
ac	ac	CONcoo	_
iampridem	iampridem	ADV	_
probatis	probatus	ADJqua	Com
aggregantur	aggrego	VER	_
nec	nec	CONcoo	_
rubor	rubor	NOM	_
inter	inter	PRE	_
comites	comes	NOM	_
aspici	aspicio	VER	_

ut	ut	CONsub	_
turbae	turba	NOM	_
placuit	placeo	VER	_
considunt	consido	VER	_
armati	armatus	ADJqua	Masc

argentum	argentum	NOM	_
et	et	CONcoo	_
aurum	aurum	NOM	_
propitii	propitius	ADJqua	Masc
-ne	ne	ADVint	_
an	an	ADVint	_
irati	iratus	ADJqua	Masc
dii	deus	NOM	_
negauerint	nego	VER	_
dubito	dubito	VER	_

sepulcrum	sepulcrum	NOM	_
caespes	caespes	NOM	_
erigit	erigo	VER	_
monumentorum	monumentum	NOM	_
arduum	arduus	ADJqua	MascNeut
et	et	CONcoo	_
operosum	operosus	ADJqua	MascNeut
honorem	honor	NOM	_
ut	ut	ADVrel	_
grauem	grauis	ADJqua	MascFem
defunctis	defungor	VER	Com
aspernantur	aspernor	VER	_

uicos	uicus	NOM	_
locant	loco	VER	_
non	non	ADVneg	_
in	in	PRE	_
nostrum	noster	PROpos	MascNeut
morem	mos	NOM	_
conexis	conecto	VER	Com
et	et	CONcoo	_
cohaerentibus	cohaereo	VER	Com
aedificiis	aedificium	NOM	_
suam	suus	PROpos.ref	Fem
quisque	quisque	PROind	Masc
domum	domus	NOM	_
spatio	spatium	NOM	_
circumdat	circumdo	VER	_
siue	siue	CONcoo	_
aduersus	aduersus	PRE	_
casus	casus	NOM	_
ignis	ignis	NOM	_
remedium	remedium	NOM	_
siue	siue	CONcoo	_
inscientia	inscientia	NOM	_
aedificandi	aedifico	VER	_

sortium	sors	NOM	_
consuetudo	consuetudo	NOM	_
simplex	simplex	ADJmul	Com

in	in	PRE	_
omni	omnis	PROind	Com
domo	domus	NOM	_
nudi	nudus	ADJqua	Masc
ac	ac	CONcoo	_
sordidi	sordidus	ADJqua	Masc
in	in	PRE	_
hos	hic	PROdem	Masc
artus	artus	NOM	_
in	in	PRE	_
haec	hic	PROdem	Neut
corpora	corpus	NOM	_
quae	qui	PROrel	Neut
miramur	miror	VER	_
excrescunt	excresco	VER	_

dotem	dos	NOM	_
non	non	ADVneg	_
uxor	uxor	NOM	_
marito	maritus	NOM	_
sed	sed	CONcoo	_
uxori	uxor	NOM	_
maritus	maritus	NOM	_
offert	offero	VER	_

funerum	funus	NOM	_
nulla	nullus	PROind	Fem
ambitio	ambitio	NOM	_
id	is	PROdem	Neut
solum	solus	PROind	Neut
obseruatur	obseruo	VER	_
ut	ut	CONsub	_
corpora	corpus	NOM	_
clarorum	clarus	ADJqua	MascNeut
uirorum	uir	NOM	_
certis	certus	ADJqua	Com
lignis	lignum	NOM	_
crementur	cremo	VER	_

eliguntur	eligo	VER	_
in	in	PRE	_
iisdem	idem	PROdem	Com
conciliis	concilium	NOM	_
et	et	ADV	_
principes	princeps	NOM	_
qui	qui	PROrel	Masc
iura	ius	NOM	_
per	per	PRE	_
pagos	pagus	NOM	_
uicos	uicus	NOM	_
-que	que	CONcoo	_
reddunt	reddo	VER	_
centeni	centenus	ADJdis	Masc
singulis	singulus	ADJdis	Com
ex	ex	PRE	_
plebe	plebs	NOM	_
comites	comes	NOM	_
consilium	consilium	NOM	_
simul	simul	ADV	_
et	et	CONcoo	_
auctoritas	auctoritas	NOM	_
adsunt	assum	VER	_

ne	ne	CONsub	_
se	sui	PROref	_
mulier	mulier	NOM	_
extra	extra	PRE	_
uirtutum	uirtus	NOM	_
cogitationes	cogitatio	NOM	_
extra	extra	PRE	_
-que	que	CONcoo	_
bellorum	bellum	NOM	_
casus	casus	NOM	_
putet	puto	VER	_
ipsis	ipse	PROdem	Com
incipientis	incipio	VER	Com
matrimonii	matrimonium	NOM	_
auspiciis	auspicium	NOM	_
admonetur	admoneo	VER	_
uenire	uenio	VER	_
se	sui	PROref	_
laborum	labor	NOM	_
periculorum	periculum	NOM	_
-que	que	CONcoo	_
sociam	socius	ADJqua	Fem
idem	idem	PROdem	Neut
in	in	PRE	_
pace	pax	NOM	_
idem	idem	PROdem	Neut
in	in	PRE	_
proelio	proelium	NOM	_
passuram	patior	VER	Fem
ausuram	audeo	VER	Fem
-que	que	CONcoo	_
hoc	hic	PROdem	Neut
iuncti	iungo	VER	Masc
boues	bos	NOM	_
hoc	hic	PROdem	Neut
paratus	paro	VER	Masc
equus	equus	NOM	_
hoc	hic	PROdem	Neut
data	do	VER	Neut
arma	arma	NOM	_
denuntiant	denuntio	VER	_

quid	quis	PROint	Neut
enim	enim	CONcoo	_
aliud	alius	PROind	Neut
nobis	nos	PROper	_
quam	quam	ADVrel	_
caedem	caedes	NOM	_
Crassi	crassus	NOM	_
amisso	amitto	VER	MascNeut
et	et	CONcoo	_
ipse	ipse	PROdem	Masc
Pacoro	pacorus	NOM	_
infra	infra	PRE	_
Ventidium	uentidius	NOM	_
deiectus	deicio	VER	Masc
Oriens	oriens	NOM	_
obiecerit	obicio	VER	_

et	et	CONcoo	_
haec	hic	PROdem	Fem
quidem	quidem	ADV	_
pars	pars	NOM	_
Sueborum	suebi	NOM	_
in	in	PRE	_
secretiora	secretus	ADJqua	Neut
Germaniae	germania	NOM	_
porrigitur	porrigo	VER	_
propior	propior	ADJqua	MascFem
ut	ut	CONsub	_
quomodo	quomodo	ADVrel	_
paulo	paulo	ADV	_
ante	ante	ADV	_
Rhenum	rhenus	NOM	_
sic	sic	ADV	_
nunc	nunc	ADV	_
Danuuium	danuuius	NOM	_
sequar	sequor	VER	_
Hermundurorum	hermunduri	NOM	_
ciuitas	ciuitas	NOM	_
fida	fidus	ADJqua	Fem
Romanis	romani	NOM	_
eo	eo	ADV	_
-que	que	CONcoo	_
solis	solus	PROind	Com
Germanorum	germani	NOM	_
non	non	ADVneg	_
in	in	PRE	_
ripa	ripa	NOM	_
commercium	commercium	NOM	_
sed	sed	CONcoo	_
penitus	penitus	ADV	_
atque	atque	CONcoo	_
in	in	PRE	_
splendidissima	splendidus	ADJqua	Fem
Raetiae	raetia	NOM	_
prouinciae	prouincia	NOM	_
colonia	colonia	NOM	_

agri	ager	NOM	_
pro	pro	PRE	_
numero	numerus	NOM	_
cultorum	cultor	NOM	_
ab	ab	PRE	_
uniuersis	uniuersi	NOM	_
inuicem	inuicem	ADV	_
occupantur	occupo	VER	_
quos	qui	PROrel	Masc
mox	mox	ADV	_
inter	inter	PRE	_
se	sui	PROref	_
secundum	secundum	PRE	_
dignationem	dignatio	NOM	_
partiuntur	partior	VER	_
facilitatem	facilitas	NOM	_
partiendi	partior	VER	_
camporum	campus	NOM	_
spatia	spatium	NOM	_
praestant	praesto	VER	_

et	et	CONcoo	_
eques	eques	NOM	_
quidem	quidem	ADV	_
scuto	scutum	NOM	_
framea	framea	NOM	_
-que	que	CONcoo	_
contentus	contentus	ADJqua	Masc
est	sum	VER	_
pedites	pedes	NOM	_
et	et	ADV	_
missilia	missile	NOM	_
spargunt	spargo	VER	_
plura	multus	ADJqua	Neut
-que	que	CONcoo	_
singuli	singulus	ADJdis	Masc
atque	atque	CONcoo	_
in	in	PRE	_
inmensum	immensum	NOM	_
uibrant	uibro	VER	_
nudi	nudus	ADJqua	Masc
aut	aut	CONcoo	_
sagulo	sagulum	NOM	_
leues	leuis	ADJqua	MascFem

frumenti	frumentum	NOM	_
modum	modus	NOM	_
dominus	dominus	NOM	_
aut	aut	CONcoo	_
pecoris	pecus	NOM	_
aut	aut	CONcoo	_
uestis	uestis	NOM	_
ut	ut	ADVrel	_
colono	colonus	NOM	_
iniungit	iniungo	VER	_
et	et	CONcoo	_
seruus	seruus	NOM	_
hactenus	hactenus	ADV	_
paret	pareo	VER	_
cetera	ceterus	ADJqua	Neut
domus	domus	NOM	_
officia	officium	NOM	_
uxor	uxor	NOM	_
ac	ac	CONcoo	_
liberi	liberi	NOM	_
exsequuntur	exsequor	VER	_

igitur	igitur	CONcoo	_
inter	inter	PRE	_
Hercyniam	hercynius	ADJqua	Fem
siluam	silua	NOM	_
Rhenum	rhenus	NOM	_
-que	que	CONcoo	_
et	et	CONcoo	_
Moenum	moenus	NOM	_
amnes	amnis	NOM	_
Heluetii	heluetii	NOM	_
ulteriora	ulteriora	NOM	_
Boii	boii	NOM	_
Gallica	gallicus	ADJqua	Fem
utraque	uterque	PROind	Fem
gens	gens	NOM	_
tenuere	teneo	VER	_

at	at	CONcoo	_
Germani	germani	NOM	_
Carbone	carbo	NOM	_
et	et	CONcoo	_
Cassio	cassius	NOM	_
et	et	CONcoo	_
Scauro	scaurus	NOM	_
Aurelio	aurelius	NOM	_
et	et	CONcoo	_
Seruilio	seruilius	NOM	_
Caepione	caepio	NOM	_
Maximo	maximus	NOM	_
-que	que	CONcoo	_
Mallio	mallius	NOM	_
fusis	fundo	VER	Com
uel	uel	CONcoo	_
captis	capio	VER	Com
quinque	quinque	ADJcar	_
simul	simul	ADV	_
consularis	consularis	ADJqua	MascFem
exercitus	exercitus	NOM	_
populo	populus	NOM	_
Romano	romanus	ADJqua	MascNeut
Varum	uarus	NOM	_
tris	tres	ADJcar	MascFem
-que	que	CONcoo	_
cum	cum	PRE	_
eo	is	PROdem	MascNeut
legiones	legio	NOM	_
etiam	etiam	ADV	_
Caesari	caesar	NOM	_
abstulerunt	aufero	VER	_
nec	nec	CONcoo	_
impune	impune	ADV	_
Caius	caius	NOM	_
Marius	marius	NOM	_
in	in	PRE	_
Italia	italia	NOM	_
Diuus	diuus	ADJqua	Masc
Iulius	iulius	NOM	_
in	in	PRE	_
Gallia	gallia	NOM	_
Drusus	drusus	NOM	_
ac	ac	CONcoo	_
Nero	nero	NOM	_
et	et	CONcoo	_
Germanicus	germanicus	NOM	_
in	in	PRE	_
suis	suus	PROpos.ref	Com
eos	is	PROdem	Masc
sedibus	sedes	NOM	_
perculerunt	percello	VER	_
mox	mox	ADV	_
ingentes	ingens	ADJqua	MascFem
Cai	caius	NOM	_
Caesaris	caesar	NOM	_
minae	minae	NOM	_
in	in	PRE	_
ludibrium	ludibrium	NOM	_
uersae	uerto	VER	Fem

fortissimus	fortis	ADJqua	Masc
quisque	quisque	PROind	Masc
ferreum	ferreus	ADJqua	MascNeut
insuper	insuper	ADV	_
anulum	anulus	NOM	_
ignominiosum	ignominiosus	ADJqua	Neut
id	is	PROdem	Neut
genti	gens	NOM	_
uelut	uelut	ADVrel	_
uinculum	uinculum	NOM	_
gestat	gesto	VER	_
donec	donec	CONsub	_
se	sui	PROref	_
caede	caedes	NOM	_
hostis	hostis	NOM	_
absoluat	absoluo	VER	_

gaudent	gaudeo	VER	_
praecipue	praecipue	ADV	_
finitimarum	finitimus	ADJqua	Fem
gentium	gens	NOM	_
donis	donum	NOM	_
quae	qui	PROrel	Neut
non	non	ADVneg	_
modo	modo	ADV	_
a	ab	PRE	_
singulis	singulus	ADJdis	Com
sed	sed	CONcoo	_
et	et	ADV	_
publice	publice	ADV	_
mittuntur	mitto	VER	_
electi	electus	ADJqua	Masc
equi	equus	NOM	_
magnifica	magnificus	ADJqua	Neut
arma	arma	NOM	_
phalerae	phalerae	NOM	_
torques	torquis	NOM	_
-que	que	CONcoo	_
iam	iam	ADV	_
et	et	ADV	_
pecuniam	pecunia	NOM	_
accipere	accipio	VER	_
docuimus	doceo	VER	_

cedere	cedo	VER	_
loco	locus	NOM	_
dummodo	dummodo	CONsub	_
rursus	rursus	ADV	_
instes	insto	VER	_
consilii	consilium	NOM	_
quam	quam	ADVrel	_
formidinis	formido	NOM	_
arbitrantur	arbitror	VER	_

eius	is	PROdem	Com
gentis	gens	NOM	_
cum	cum	PRE	_
qua	qui	PROrel	Fem
bellum	bellum	NOM	_
est	sum	VER	_
captiuum	captiuus	NOM	_
quoquo	quisquis	PROind	MascNeut
modo	modus	NOM	_
interceptum	intercipio	VER	MascNeut
cum	cum	PRE	_
electo	eligo	VER	MascNeut
popularium	popularis	NOM	_
suorum	suus	PROpos.ref	MascNeut
patriis	patrius	ADJqua	Com
quemque	quisque	PROind	Masc
armis	arma	NOM	_
committunt	committo	VER	_
uictoria	uictoria	NOM	_
huius	hic	PROdem	Com
uel	uel	CONcoo	_
illius	ille	PROdem	Com
pro	pro	PRE	_
praeiudicio	praeiudicium	NOM	_
accipitur	accipio	VER	_

nec	nec	CONcoo	_
uelis	uelum	NOM	_
ministrant	ministro	VER	_
nec	nec	CONcoo	_
remos	remus	NOM	_
in	in	PRE	_
ordinem	ordo	NOM	_
lateribus	latus	NOM	_
adiungunt	adiungo	VER	_
solutum	solutus	ADJqua	Neut
ut	ut	ADVrel	_
in	in	PRE	_
quibusdam	quidam	PROind	Com
fluminum	flumen	NOM	_
et	et	CONcoo	_
mutabile	mutabilis	ADJqua	Neut
ut	ut	ADVrel	_
res	res	NOM	_
poscit	posco	VER	_
hinc	hinc	ADV	_
uel	uel	CONcoo	_
illinc	illinc	ADV	_
remigium	remigium	NOM	_

ipsos	ipse	PROdem	Masc
Germanos	germani	NOM	_
indigenas	indigena	NOM	_
crediderim	credo	VER	_
minime	parum	ADV	_
-que	que	CONcoo	_
aliarum	alius	PROind	Fem
gentium	gens	NOM	_
aduentibus	aduentus	NOM	_
et	et	CONcoo	_
hospitiis	hospitium	NOM	_
mixtos	misceo	VER	Masc
quia	quia	CONsub	_
nec	nec	CONcoo	_
terra	terra	NOM	_
olim	olim	ADV	_
sed	sed	CONcoo	_
classibus	classis	NOM	_
aduehebantur	aduehor	VER	_
qui	qui	PROrel	Masc
mutare	muto	VER	_
sedes	sedes	NOM	_
quaerebant	quaero	VER	_
et	et	CONcoo	_
immensus	immensus	ADJqua	Masc
ultra	ultra	ADV	_
ut	ut	CONsub	_
-que	que	CONcoo	_
sic	sic	ADV	_
dixerim	dico	VER	_
aduersus	aduersus	ADJqua	Masc
Oceanus	oceanus	NOM	_
raris	rarus	ADJqua	MascNeut
ab	ab	PRE	_
orbe	orbis	NOM	_
nostro	noster	PROpos	MascNeut
nauibus	nauis	NOM	_
aditur	adeo	VER	_

serui	seruus	NOM	_
ministrant	ministro	VER	_
quos	qui	PROrel	Masc
statim	statim	ADV	_
idem	idem	PROdem	MascNeut
lacus	lacus	NOM	_
haurit	haurio	VER	_

ualidiores	ualidus	ADJqua	MascFem
olim	olim	ADV	_
Gallorum	galli	NOM	_
res	res	NOM	_
fuisse	sum	VER	_
summus	superus	ADJqua	Masc
auctorum	auctor	NOM	_
Diuus	diuus	ADJqua	Masc
Iulius	iulius	NOM	_
tradit	trado	VER	_
eo	eo	ADV	_
-que	que	CONcoo	_
credibile	credibilis	ADJqua	Neut
est	sum	VER	_
etiam	etiam	ADV	_
Gallos	galli	NOM	_
in	in	PRE	_
Germaniam	germania	NOM	_
transgressos	transgredior	VER	Masc

nec	nec	CONcoo	_
solum	solum	ADV	_
in	in	PRE	_
sua	suus	PROpos.ref	Fem
gente	gens	NOM	_
cuique	quisque	PROind	Com
sed	sed	CONcoo	_
apud	apud	PRE	_
finitimas	finitimus	ADJqua	Fem
quoque	quoque	ADV	_
ciuitates	ciuitas	NOM	_
id	is	PROdem	Neut
nomen	nomen	NOM	_
ea	is	PROdem	Fem
gloria	gloria	NOM	_
est	sum	VER	_
si	si	CONsub	_
numero	numerus	NOM	_
ac	ac	CONcoo	_
uirtute	uirtus	NOM	_
comitatus	comitatus	NOM	_
emineat	emineo	VER	_
expetuntur	expeto	VER	_
enim	enim	CONcoo	_
legationibus	legatio	NOM	_
et	et	CONcoo	_
muneribus	munus	NOM	_
ornantur	orno	VER	_
et	et	CONcoo	_
ipsa	ipse	PROdem	Fem
plerumque	plerumque	ADV	_
fama	fama	NOM	_
bella	bellum	NOM	_
profligant	profligo	VER	_

uerberare	uerbero	VER	_
seruum	seruus	NOM	_
ac	ac	CONcoo	_
uinculis	uinculum	NOM	_
et	et	CONcoo	_
opere	opus	NOM	_
coercere	coerceo	VER	_
rarum	rarus	ADJqua	Neut
solent	soleo	VER	_
non	non	ADVneg	_
disciplina	disciplina	NOM	_
et	et	CONcoo	_
seueritate	seueritas	NOM	_
sed	sed	CONcoo	_
impetu	impetus	NOM	_
et	et	CONcoo	_
ira	ira	NOM	_
ut	ut	ADVrel	_
inimicum	inimicus	NOM	_
nisi	nisi	CONsub	_
quod	quod	CONsub	_
impune	impune	ADV	_
est	sum	VER	_

pars	pars	NOM	_
Sueborum	suebi	NOM	_
et	et	ADV	_
Isidi	isis	NOM	_
sacrificat	sacrifico	VER	_
unde	unde	ADVint	_
causa	causa	NOM	_
et	et	CONcoo	_
origo	origo	NOM	_
peregrino	peregrinus	ADJqua	MascNeut
sacro	sacrum	NOM	_
parum	parum	ADV	_
comperi	comperio	VER	_
nisi	nisi	CONsub	_
quod	quod	CONsub	_
signum	signum	NOM	_
ipsum	ipse	PROdem	Neut
in	in	PRE	_
modum	modus	NOM	_
liburnae	liburna	NOM	_
figuratum	figuro	VER	Neut
docet	doceo	VER	_
aduectam	adueho	VER	Fem
religionem	religio	NOM	_

nulla	nullus	PROind	Fem
cultus	cultus	NOM	_
iactatio	iactatio	NOM	_
scuta	scutum	NOM	_
tantum	tantum	ADV	_
lectissimis	lectus	ADJqua	Com
coloribus	color	NOM	_
distinguunt	distinguo	VER	_

exercitatio	exercitatio	NOM	_
artem	ars	NOM	_
parauit	paro	VER	_
ars	ars	NOM	_
decorem	decor	NOM	_
non	non	ADVneg	_
in	in	PRE	_
quaestum	quaestus	NOM	_
tamen	tamen	ADV	_
aut	aut	CONcoo	_
mercedem	merces	NOM	_
quamuis	quamuis	ADVrel	_
audacis	audax	ADJqua	Com
lasciuiae	lasciuia	NOM	_
pretium	pretium	NOM	_
est	sum	VER	_
uoluptas	uoluptas	NOM	_
spectantium	specto	VER	Com

nec	nec	CONcoo	_
quicquam	quisquam	PROind	Neut
notabile	notabilis	ADJqua	Neut
in	in	PRE	_
singulis	singulus	ADJdis	Com
nisi	nisi	CONsub	_
quod	quod	CONsub	_
in	in	PRE	_
commune	commune	NOM	_
Nerthum	nerthus	NOM	_
id	is	PROdem	Neut
est	sum	VER	_
Terram	terra	NOM	_
matrem	mater	NOM	_
colunt	colo	VER	_
eam	is	PROdem	Fem
-que	que	CONcoo	_
interuenire	interuenio	VER	_
rebus	res	NOM	_
hominum	homo	NOM	_
inuehi	inueho	VER	_
populis	populus	NOM	_
arbitrantur	arbitror	VER	_

iam	iam	ADV	_
uero	uero	CONcoo	_
infame	infamis	ADJqua	Neut
in	in	PRE	_
omnem	omnis	PROind	MascFem
uitam	uita	NOM	_
ac	ac	CONcoo	_
probrosum	probrosus	ADJqua	Neut
superstitem	superstes	ADJqua	MascFem
principi	princeps	NOM	_
suo	suus	PROpos.ref	MascNeut
ex	ex	PRE	_
acie	acies	NOM	_
recessisse	recedo	VER	_
illum	ille	PROdem	Masc
defendere	defendo	VER	_
tueri	tueor	VER	_
sua	suus	PROpos.ref	Neut
quoque	quoque	ADV	_
fortia	fortis	ADJqua	Neut
facta	factum	NOM	_
gloriae	gloria	NOM	_
eius	is	PROdem	Com
assignare	assigno	VER	_
praecipuum	praecipuus	ADJqua	Neut
sacramentum	sacramentum	NOM	_
est	sum	VER	_
principes	princeps	NOM	_
pro	pro	PRE	_
uictoria	uictoria	NOM	_
pugnant	pugno	VER	_
comites	comes	NOM	_
pro	pro	PRE	_
principe	princeps	NOM	_

nullas	nullus	PROind	Fem
Germanorum	germani	NOM	_
populis	populus	NOM	_
urbes	urbs	NOM	_
habitari	habito	VER	_
satis	satis	ADV	_
notum	notus	ADJqua	Neut
est	sum	VER	_
ne	ne	ADVneg	_
pati	patior	VER	_
quidem	quidem	ADV	_
inter	inter	PRE	_
se	sui	PROref	_
iunctas	iungo	VER	Fem
sedes	sedes	NOM	_

diuersitas	diuersitas	NOM	_
supplicii	supplicium	NOM	_
illuc	illuc	ADV	_
respicit	respicio	VER	_
tamquam	tamquam	CONsub	_
scelera	scelus	NOM	_
ostendi	ostendo	VER	_
oporteat	oportet	VER	_
dum	dum	CONsub	_
puniuntur	punio	VER	_
flagitia	flagitium	NOM	_
abscondi	abscondo	VER	_

ipsam	ipse	PROdem	Fem
Rheni	rhenus	NOM	_
ripam	ripa	NOM	_
haud	haud	ADVneg	_
dubie	dubie	ADV	_
Germanorum	germani	NOM	_
populi	populus	NOM	_
colunt	colo	VER	_
Vangiones	uangiones	NOM	_
Triboci	triboci	NOM	_
Nemetes	nemetes	NOM	_

numerum	numerus	NOM	_
liberorum	liberi	NOM	_
finire	finio	VER	_
aut	aut	CONcoo	_
quemquam	quisquam	PROind	MascFem
ex	ex	PRE	_
agnatis	agnatus	NOM	_
necare	neco	VER	_
flagitium	flagitium	NOM	_
habetur	habeo	VER	_
plus	multum	ADV	_
-que	que	CONcoo	_
ibi	ibi	ADV	_
boni	bonus	ADJqua	Masc
mores	mos	NOM	_
ualent	ualeo	VER	_
quam	quam	ADVrel	_
alibi	alibi	ADV	_
bonae	bonus	ADJqua	Fem
leges	lex	NOM	_

cum	cum	CONsub	_
uentum	uenio	VER	Neut
in	in	PRE	_
aciem	acies	NOM	_
turpe	turpis	ADJqua	Neut
principi	princeps	NOM	_
uirtute	uirtus	NOM	_
uinci	uinco	VER	_
turpe	turpis	ADJqua	Neut
comitatui	comitatus	NOM	_
uirtutem	uirtus	NOM	_
principis	princeps	NOM	_
non	non	ADVneg	_
adaequare	adaequo	VER	_

forma	forma	NOM	_
nauium	nauis	NOM	_
eo	eo	ADV	_
differt	differo	VER	_
quod	quod	CONsub	_
utrimque	utrimque	ADV	_
prora	prora	NOM	_
paratam	paratus	ADJqua	Fem
semper	semper	ADV	_
appulsui	appulsus	NOM	_
frontem	frons	NOM	_
agit	ago	VER	_

inesse	insum	VER	_
quin	quin	ADV	_
etiam	etiam	ADV	_
sanctum	sanctus	ADJqua	MascNeut
aliquid	aliquis	PROind	Neut
et	et	CONcoo	_
prouidum	prouidus	ADJqua	MascNeut
putant	puto	VER	_
nec	nec	CONcoo	_
aut	aut	CONcoo	_
consilia	consilium	NOM	_
earum	is	PROdem	Fem
aspernantur	aspernor	VER	_
aut	aut	CONcoo	_
responsa	responsum	NOM	_
neglegunt	negligo	VER	_

id	is	PROdem	Neut
praecipuum	praecipuus	ADJqua	Neut
uirtutis	uirtus	NOM	_
ac	ac	CONcoo	_
uirium	uis	NOM	_
argumentum	argumentum	NOM	_
est	sum	VER	_
quod	quod	CONsub	_
ut	ut	CONsub	_
superiores	superus	ADJqua	MascFem
agant	ago	VER	_
non	non	ADVneg	_
per	per	PRE	_
iniurias	iniuria	NOM	_
assequuntur	assequor	VER	_
prompta	promptus	ADJqua	Neut
tamen	tamen	ADV	_
omnibus	omnis	PROind	Com
arma	arma	NOM	_
ac	ac	CONcoo	_
si	si	CONsub	_
res	res	NOM	_
poscat	posco	VER	_
exercitus	exercitus	NOM	_
plurimum	multus	ADJqua	Neut
uirorum	uir	NOM	_
equorum	equus	NOM	_
-que	que	CONcoo	_
et	et	CONcoo	_
quiescentibus	quiesco	VER	Com
eadem	idem	PROdem	Fem
fama	fama	NOM	_

manet	maneo	VER	_
honos	honor	NOM	_
et	et	CONcoo	_
antiquae	antiquus	ADJqua	Fem
societatis	societas	NOM	_
insigne	insigne	NOM	_
nam	nam	CONcoo	_
nec	nec	CONcoo	_
tributis	tributum	NOM	_
contemnuntur	contemno	VER	_
nec	nec	CONcoo	_
publicanus	publicanus	NOM	_
atterit	attero	VER	_
exempti	eximo	VER	Masc
oneribus	onus	NOM	_
et	et	CONcoo	_
collationibus	collatio	NOM	_
et	et	CONcoo	_
tantum	tantum	ADV	_
in	in	PRE	_
usum	usus	NOM	_
proeliorum	proelium	NOM	_
sepositi	sepono	VER	Masc
uelut	uelut	ADVrel	_
tela	telum	NOM	_
atque	atque	CONcoo	_
arma	arma	NOM	_
bellis	bellum	NOM	_
reseruantur	reseruo	VER	_

ergo	ergo	CONcoo	_
iam	iam	ADV	_
dextro	dexter	ADJqua	MascNeut
Suebici	suebicus	ADJqua	MascNeut
maris	mare	NOM	_
litore	litus	NOM	_
Aestiorum	aestii	NOM	_
gentes	gens	NOM	_
adluuntur	adluo	VER	_
quibus	qui	PROrel	Com
ritus	ritus	NOM	_
habitus	habitus	NOM	_
-que	que	CONcoo	_
Sueborum	suebi	NOM	_
lingua	lingua	NOM	_
Britannicae	britannicus	ADJqua	Fem
propior	propior	ADJqua	MascFem

ergo	ergo	CONcoo	_
saepta	saepio	VER	Fem
pudicitia	pudicitia	NOM	_
agunt	ago	VER	_
nullis	nullus	PROind	Com
spectaculorum	spectaculum	NOM	_
illecebris	illecebra	NOM	_
nullis	nullus	PROind	Com
conuiuiorum	conuiuium	NOM	_
irritationibus	irritatio	NOM	_
corruptae	corrumpo	VER	Fem

partem	pars	NOM	_
tributorum	tributum	NOM	_
Sarmatae	sarmatae	NOM	_
partem	pars	NOM	_
Quadi	quadi	NOM	_
ut	ut	ADVrel	_
alienigenis	alienigena	NOM	_
imponunt	impono	VER	_
Cotini	cotini	NOM	_
quo	quo	ADVrel	_
magis	magis	ADV	_
pudeat	pudeo	VER	_
et	et	ADV	_
ferrum	ferrum	NOM	_
effodiunt	effodio	VER	_

sunt	sum	VER	_
illis	ille	PROdem	Com
haec	hic	PROdem	Neut
quoque	quoque	ADV	_
carmina	carmen	NOM	_
quorum	qui	PROrel	MascNeut
relatu	relatus	NOM	_
quem	qui	PROrel	Masc
barditum	barditus	NOM	_
uocant	uoco	VER	_
accendunt	accendo	VER	_
animos	animus	NOM	_
futurae	futurus	ADJqua	Fem
-que	que	CONcoo	_
pugnae	pugna	NOM	_
fortunam	fortuna	NOM	_
ipso	ipse	PROdem	MascNeut
cantu	cantus	NOM	_
augurantur	auguror	VER	_
terrent	terreo	VER	_
enim	enim	CONcoo	_
trepidant	trepido	VER	_
-ue	ue	CONcoo	_
prout	prout	ADVrel	_
sonuit	sono	VER	_
acies	acies	NOM	_
nec	nec	CONcoo	_
tam	tam	ADV	_
uoces	uox	NOM	_
illae	ille	PROdem	Fem
quam	quam	ADVrel	_
uirtutis	uirtus	NOM	_
concentus	concentus	NOM	_
uidentur	uideo	VER	_

paucissima	paucus	ADJqua	Neut
in	in	PRE	_
tam	tam	ADV	_
numerosa	numerosus	ADJqua	Fem
gente	gens	NOM	_
adulteria	adulterium	NOM	_
quorum	qui	PROrel	MascNeut
poena	poena	NOM	_
praesens	praesens	ADJqua	Com
et	et	CONcoo	_
maritis	maritus	NOM	_
permissa	permitto	VER	Fem
abscisis	abscindo	VER	Com
crinibus	crinis	NOM	_
nudatam	nudo	VER	Fem
coram	coram	PRE	_
propinquis	propinquus	ADJqua	Com
expellit	expello	VER	_
domo	domus	NOM	_
maritus	maritus	NOM	_
ac	ac	CONcoo	_
per	per	PRE	_
omnem	omnis	PROind	MascFem
uicum	uicus	NOM	_
uerbere	uerber	NOM	_
agit	ago	VER	_
publicatae	publico	VER	Fem
enim	enim	CONcoo	_
pudicitiae	pudicitia	NOM	_
nulla	nullus	PROind	Fem
uenia	uenia	NOM	_
non	non	ADVneg	_
forma	forma	NOM	_
non	non	ADVneg	_
aetate	aetas	NOM	_
non	non	ADVneg	_
opibus	ops	NOM	_
maritum	maritus	NOM	_
inuenerit	inuenio	VER	_

ita	ita	ADV	_
qui	qui	PROrel	Masc
olim	olim	ADV	_
boni	bonus	ADJqua	Masc
aequi	aequus	ADJqua	Masc
-que	que	CONcoo	_
Cherusci	cherusci	NOM	_
nunc	nunc	ADV	_
inertes	iners	ADJqua	MascFem
ac	ac	CONcoo	_
stulti	stultus	ADJqua	Masc
uocantur	uoco	VER	_
Chattis	chatti	NOM	_
uictoribus	uictor	NOM	_
fortuna	fortuna	NOM	_
in	in	PRE	_
sapientiam	sapientia	NOM	_
cessit	cedo	VER	_

uirgam	uirga	NOM	_
frugiferae	frugifer	ADJqua	Fem
arbori	arbor	NOM	_
decisam	decido	VER	Fem
in	in	PRE	_
surculos	surculus	NOM	_
amputant	amputo	VER	_
eos	is	PROdem	Masc
-que	que	CONcoo	_
notis	nota	NOM	_
quibusdam	quidam	PROind	Com
discretos	discerno	VER	Masc
super	super	PRE	_
candidam	candidus	ADJqua	Fem
uestem	uestis	NOM	_
temere	temere	ADV	_
ac	ac	CONcoo	_
fortuito	fortuito	ADV	_
spargunt	spargo	VER	_

non	non	ADVneg	_
Samnis	samnis	ADJqua	MascFem
non	non	ADVneg	_
Poeni	poeni	NOM	_
non	non	ADVneg	_
Hispaniae	hispania	NOM	_
Galliae	gallia	NOM	_
-ue	ue	CONcoo	_
ne	ne	ADVneg	_
Parthi	parthi	NOM	_
quidem	quidem	ADV	_
saepius	saepe	ADV	_
admonuere	admoneo	VER	_
quippe	quippe	CONcoo	_
regno	regnum	NOM	_
Arsacis	arsaces	NOM	_
acrior	acer	ADJqua	MascFem
est	sum	VER	_
Germanorum	germani	NOM	_
libertas	libertas	NOM	_

est	sum	VER	_
et	et	ADV	_
alia	alius	PROind	Fem
luco	lucus	NOM	_
reuerentia	reuerentia	NOM	_
nemo	nemo	PROind	_
nisi	nisi	CONsub	_
uinculo	uinculum	NOM	_
ligatus	ligo	VER	Masc
ingreditur	ingredior	VER	_
ut	ut	ADVrel	_
minor	paruus	ADJqua	MascFem
et	et	CONcoo	_
potestatem	potestas	NOM	_
numinis	numen	NOM	_
prae	prae	PRE	_
se	sui	PROref	_
ferens	fero	VER	Com

omnium	omnis	PROind	Com
penes	penes	PRE	_
hos	hic	PROdem	Masc
initia	initium	NOM	_
pugnarum	pugna	NOM	_
haec	hic	PROdem	Fem
prima	primus	ADJord	Fem
semper	semper	ADV	_
acies	acies	NOM	_
uisu	uideo	VER	_
noua	nouus	ADJqua	Fem
nam	nam	CONcoo	_
ne	ne	ADVneg	_
in	in	PRE	_
pace	pax	NOM	_
quidem	quidem	ADV	_
uultu	uultus	NOM	_
mitiore	mitis	ADJqua	Com
mansuescunt	mansuesco	VER	_

Reudigni	reudigni	NOM	_
deinde	deinde	ADV	_
et	et	CONcoo	_
Auiones	auiones	NOM	_
et	et	CONcoo	_
Anglii	anglii	NOM	_
et	et	CONcoo	_
Varini	uarini	NOM	_
et	et	CONcoo	_
Eudoses	eudoses	NOM	_
et	et	CONcoo	_
Suardones	suardones	NOM	_
et	et	CONcoo	_
Nuitones	nuitones	NOM	_
fluminibus	flumen	NOM	_
aut	aut	CONcoo	_
siluis	silua	NOM	_
muniuntur	munio	VER	_

sine	sine	PRE	_
cupiditate	cupiditas	NOM	_
sine	sine	PRE	_
impotentia	impotentia	NOM	_
quieti	quietus	ADJqua	Masc
secreti	secretus	ADJqua	Masc
-que	que	CONcoo	_
nulla	nullus	PROind	Neut
prouocant	prouoco	VER	_
bella	bellum	NOM	_
nullis	nullus	PROind	Com
raptibus	raptus	NOM	_
aut	aut	CONcoo	_
latrociniis	latrocinium	NOM	_
populantur	populor	VER	_

protinus	protinus	ADV	_
deinde	deinde	ADV	_
ab	ab	PRE	_
Oceano	oceanus	NOM	_
Rugii	rugii	NOM	_
et	et	CONcoo	_
Lemouii	lemouii	NOM	_
omnium	omnis	PROind	Com
-que	que	CONcoo	_
harum	hic	PROdem	Fem
gentium	gens	NOM	_
insigne	insigne	NOM	_
rotunda	rotundus	ADJqua	Neut
scuta	scutum	NOM	_
breues	breuis	ADJqua	MascFem
gladii	gladius	NOM	_
et	et	CONcoo	_
erga	erga	PRE	_
reges	rex	NOM	_
obsequium	obsequium	NOM	_

nihil	nihil	PROind	_
autem	autem	CONcoo	_
neque	neque	CONcoo	_
publicae	publicus	ADJqua	Fem
neque	neque	CONcoo	_
priuatae	priuatus	ADJqua	Fem
rei	res	NOM	_
nisi	nisi	CONsub	_
armati	armatus	ADJqua	Masc
agunt	ago	VER	_

ualentissimas	ualens	ADJqua	Fem
nominasse	nomino	VER	_
sufficiet	sufficio	VER	_
Harios	harii	NOM	_
Helueconas	helueconae	NOM	_
Manimos	manimi	NOM	_
Helisios	helisii	NOM	_
Nahanarualos	nahanaruali	NOM	_

mos	mos	NOM	_
est	sum	VER	_
ciuitatibus	ciuitas	NOM	_
ultro	ultro	ADV	_
ac	ac	CONcoo	_
uiritim	uiritim	ADV	_
conferre	confero	VER	_
principibus	princeps	NOM	_
uel	uel	CONcoo	_
armentorum	armentum	NOM	_
uel	uel	CONcoo	_
frugum	frux	NOM	_
quod	qui	PROrel	Neut
pro	pro	PRE	_
honore	honor	NOM	_
acceptum	accipio	VER	Neut
etiam	etiam	ADV	_
necessitatibus	necessitas	NOM	_
subuenit	subuenio	VER	_

effigies	effigies	NOM	_
-que	que	CONcoo	_
et	et	CONcoo	_
signa	signum	NOM	_
quaedam	quidam	PROind	Neut
detracta	detraho	VER	Neut
lucis	lucus	NOM	_
in	in	PRE	_
proelium	proelium	NOM	_
ferunt	fero	VER	_
quod	qui	PROrel	Neut
-que	que	CONcoo	_
praecipuum	praecipuus	ADJqua	Neut
fortitudinis	fortitudo	NOM	_
incitamentum	incitamentum	NOM	_
est	sum	VER	_
non	non	ADVneg	_
casus	casus	NOM	_
nec	nec	CONcoo	_
fortuita	fortuitus	ADJqua	Fem
conglobatio	conglobatio	NOM	_
turmam	turma	NOM	_
aut	aut	CONcoo	_
cuneum	cuneus	NOM	_
facit	facio	VER	_
sed	sed	CONcoo	_
familiae	familia	NOM	_
et	et	CONcoo	_
propinquitates	propinquitas	NOM	_
et	et	CONcoo	_
in	in	PRE	_
proximo	proximum	NOM	_
pignora	pignus	NOM	_
unde	unde	ADVrel	_
feminarum	femina	NOM	_
ululatus	ululatus	NOM	_
audiri	audio	VER	_
unde	unde	ADVrel	_
uagitus	uagitus	NOM	_
infantium	infans	NOM	_

si	si	CONsub	_
liberi	liberi	NOM	_
non	non	ADVneg	_
sunt	sum	VER	_
proximus	propior	ADJqua	Masc
gradus	gradus	NOM	_
in	in	PRE	_
possessione	possessio	NOM	_
fratres	frater	NOM	_
patrui	patruus	NOM	_
auunculi	auunculus	NOM	_

tum	tum	ADV	_
ad	ad	PRE	_
negotia	negotium	NOM	_
nec	nec	CONcoo	_
minus	parum	ADV	_
saepe	saepe	ADV	_
ad	ad	PRE	_
conuiuia	conuiuium	NOM	_
procedunt	procedo	VER	_
armati	armatus	ADJqua	Masc

auspicia	auspicium	NOM	_
sortes	sors	NOM	_
-que	que	CONcoo	_
ut	ut	ADVrel	_
qui	qui	PROrel	Masc
maxime	magis	ADV	_
obseruant	obseruo	VER	_

nec	nec	CONcoo	_
aliud	alius	PROind	Neut
infantibus	infans	NOM	_
ferarum	fera	NOM	_
imbrium	imber	NOM	_
-que	que	CONcoo	_
suffugium	suffugium	NOM	_
quam	quam	ADVrel	_
ut	ut	CONsub	_
in	in	PRE	_
aliquo	aliquis	PROind	MascNeut
ramorum	ramus	NOM	_
nexu	nexus	NOM	_
contegantur	contego	VER	_
huc	huc	ADV	_
redeunt	redeo	VER	_
iuuenes	iuuenis	NOM	_
hoc	hic	PROdem	Neut
senum	senex	NOM	_
receptaculum	receptaculum	NOM	_

adicit	adicio	VER	_
auctoritatem	auctoritas	NOM	_
fortuna	fortuna	NOM	_
Semnonum	semnones	NOM	_
centum	centum	ADJcar	_
pagi	pagus	NOM	_
iis	is	PROdem	Com
habitantur	habito	VER	_
magno	magnus	ADJqua	MascNeut
-que	que	CONcoo	_
corpore	corpus	NOM	_
efficitur	efficio	VER	_
ut	ut	CONsub	_
se	sui	PROref	_
Sueborum	suebi	NOM	_
caput	caput	NOM	_
credant	credo	VER	_

conubiis	connubium	NOM	_
mixtis	misceo	VER	Com
nonnihil	nonnihil	PROind	_
in	in	PRE	_
Sarmatarum	sarmatae	NOM	_
habitum	habitus	NOM	_
foedantur	foedo	VER	_

ceterum	ceterum	ADV	_
nec	nec	CONcoo	_
cohibere	cohibeo	VER	_
parietibus	paries	NOM	_
deos	deus	NOM	_
neque	neque	CONcoo	_
in	in	PRE	_
ullam	ullus	PROind	Fem
humani	humanus	ADJqua	MascNeut
oris	os	NOM	_
speciem	species	NOM	_
assimulare	assimulo	VER	_
ex	ex	PRE	_
magnitudine	magnitudo	NOM	_
caelestium	caelestes	NOM	_
arbitrantur	arbitror	VER	_
lucos	lucus	NOM	_
ac	ac	CONcoo	_
nemora	nemus	NOM	_
consecrant	consecro	VER	_
deorum	deus	NOM	_
-que	que	CONcoo	_
nominibus	nomen	NOM	_
appellant	appello	VER	_
secretum	secretum	NOM	_
illud	ille	PROdem	Neut
quod	qui	PROrel	Neut
sola	solus	PROind	Fem
reuerentia	reuerentia	NOM	_
uident	uideo	VER	_

potui	potus	NOM	_
humor	humor	NOM	_
ex	ex	PRE	_
hordeo	hordeum	NOM	_
aut	aut	CONcoo	_
frumento	frumentum	NOM	_
in	in	PRE	_
quandam	quidam	PROind	Fem
similitudinem	similitudo	NOM	_
uini	uinum	NOM	_
corruptus	corrumpo	VER	Masc
proximi	propior	ADJqua	Masc
ripae	ripa	NOM	_
et	et	ADV	_
uinum	uinum	NOM	_
mercantur	mercor	VER	_

quemcumque	quicumque	PROind	Masc
mortalium	mortalis	NOM	_
arcere	arceo	VER	_
tecto	tectum	NOM	_
nefas	nefas	NOM	_
habetur	habeo	VER	_
pro	pro	PRE	_
fortuna	fortuna	NOM	_
quisque	quisque	PROind	Masc
apparatis	apparatus	ADJqua	Com
epulis	epulae	NOM	_
excipit	excipio	VER	_

et	et	ADV	_
illud	ille	PROdem	Neut
quidem	quidem	ADV	_
etiam	etiam	ADV	_
hic	hic	ADV	_
notum	notus	ADJqua	Neut
auium	auis	NOM	_
uoces	uox	NOM	_
uolatus	uolatus	NOM	_
-que	que	CONcoo	_
interrogare	interrogo	VER	_
proprium	proprius	ADJqua	Neut
gentis	gens	NOM	_
equorum	equus	NOM	_
quoque	quoque	ADV	_
praesagia	praesagium	NOM	_
ac	ac	CONcoo	_
monitus	monitus	NOM	_
experiri	experior	VER	_

stato	status	ADJqua	MascNeut
tempore	tempus	NOM	_
in	in	PRE	_
siluam	silua	NOM	_
auguriis	augurium	NOM	_
patrum	pater	NOM	_
et	et	CONcoo	_
prisca	priscus	ADJqua	Fem
formidine	formido	NOM	_
sacram	sacer	ADJqua	Fem
omnes	omnis	PROind	MascFem
eiusdem	idem	PROdem	Com
sanguinis	sanguis	NOM	_
populi	populus	NOM	_
legationibus	legatio	NOM	_
coeunt	coeo	VER	_
caeso	caedo	VER	MascNeut
-que	que	CONcoo	_
publice	publice	ADV	_
homine	homo	NOM	_
celebrant	celebro	VER	_
barbari	barbarus	ADJqua	MascNeut
ritus	ritus	NOM	_
horrenda	horrendus	ADJqua	Neut
primordia	primordium	NOM	_

distinctio	distinctio	NOM	_
poenarum	poena	NOM	_
ex	ex	PRE	_
delicto	delictum	NOM	_
proditores	proditor	NOM	_
et	et	CONcoo	_
transfugas	transfuga	NOM	_
arboribus	arbor	NOM	_
suspendunt	suspendo	VER	_
ignauos	ignauus	NOM	_
et	et	CONcoo	_
inbelles	imbellis	ADJqua	MascFem
et	et	CONcoo	_
corpore	corpus	NOM	_
infames	infamis	ADJqua	MascFem
caeno	caenum	NOM	_
ac	ac	CONcoo	_
palude	palus	NOM	_
iniecta	inicio	VER	Fem
insuper	insuper	ADV	_
crate	crates	NOM	_
mergunt	mergo	VER	_

matrem	mater	NOM	_
deum	deus	NOM	_
uenerantur	ueneror	VER	_

feminis	femina	NOM	_
lugere	lugeo	VER	_
honestum	honestus	ADJqua	Neut
est	sum	VER	_
uiris	uir	NOM	_
meminisse	memini	VER	_

idem	idem	PROdem	MascNeut
-que	que	CONcoo	_
uenatus	uenatus	NOM	_
uiros	uir	NOM	_
pariter	pariter	ADV	_
ac	ac	CONsub	_
feminas	femina	NOM	_
alit	alo	VER	_
passim	passim	ADV	_
enim	enim	CONcoo	_
comitantur	comitor	VER	_
partem	pars	NOM	_
-que	que	CONcoo	_
praedae	praeda	NOM	_
petunt	peto	VER	_

trans	trans	PRE	_
Suionas	suionae	NOM	_
aliud	alius	PROind	Neut
mare	mare	NOM	_
pigrum	piger	ADJqua	Neut
ac	ac	CONcoo	_
prope	prope	ADV	_
immotum	immotus	ADJqua	Neut
quo	qui	PROrel	MascNeut
cingi	cingo	VER	_
cludi	cludo	VER	_
-que	que	CONcoo	_
terrarum	terra	NOM	_
orbem	orbis	NOM	_
hinc	hinc	ADV	_
fides	fides	NOM	_
quod	quod	CONsub	_
extremus	exter	ADJqua	Masc
cadentis	cado	VER	Com
iam	iam	ADV	_
solis	sol	NOM	_
fulgor	fulgor	NOM	_
in	in	PRE	_
ortus	ortus	NOM	_
edurat	eduro	VER	_
adeo	adeo	ADV	_
clarus	clarus	ADJqua	Masc
ut	ut	CONsub	_
sidera	sidus	NOM	_
hebetet	hebeto	VER	_
sonum	sonus	NOM	_
insuper	insuper	ADV	_
emergentis	emergo	VER	Com
audiri	audio	VER	_
formas	forma	NOM	_
-que	que	CONcoo	_
equorum	equus	NOM	_
et	et	CONcoo	_
radios	radius	NOM	_
capitis	caput	NOM	_
aspici	aspicio	VER	_
persuasio	persuasio	NOM	_
adicit	adicio	VER	_

litterarum	littera	NOM	_
secreta	secretum	NOM	_
uiri	uir	NOM	_
pariter	pariter	ADV	_
ac	ac	CONcoo	_
feminae	femina	NOM	_
ignorant	ignoro	VER	_

duriora	durus	ADJqua	Neut
genti	gens	NOM	_
corpora	corpus	NOM	_
stricti	strictus	ADJqua	Masc
artus	artus	NOM	_
minax	minax	ADJqua	Com
uultus	uultus	NOM	_
et	et	CONcoo	_
maior	magnus	ADJqua	MascFem
animi	animus	NOM	_
uigor	uigor	NOM	_

manet	maneo	VER	_
adhuc	adhuc	ADV	_
Boihaemi	boihaemum	NOM	_
nomen	nomen	NOM	_
significat	significo	VER	_
-que	que	CONcoo	_
loci	locus	NOM	_
ueterem	uetus	ADJqua	MascFem
memoriam	memoria	NOM	_
quamuis	quamuis	ADVrel	_
mutatis	muto	VER	Com
cultoribus	cultor	NOM	_

nec	nec	CONcoo	_
interest	intersum	VER	_
pari	par	ADJqua	Com
humanitate	humanitas	NOM	_
accipiuntur	accipio	VER	_

gradus	gradus	NOM	_
quin	quin	ADV	_
etiam	etiam	ADV	_
ipse	ipse	PROdem	Masc
comitatus	comitatus	NOM	_
habet	habeo	VER	_
iudicio	iudicium	NOM	_
eius	is	PROdem	Com
quem	qui	PROrel	Masc
sectantur	sector	VER	_
magna	magnus	ADJqua	Fem
-que	que	CONcoo	_
et	et	CONcoo	_
comitum	comes	NOM	_
aemulatio	aemulatio	NOM	_
quibus	qui	PROrel	Com
primus	primus	ADJord	Masc
apud	apud	PRE	_
principem	princeps	NOM	_
suum	suus	PROpos.ref	MascNeut
locus	locus	NOM	_
et	et	CONcoo	_
principum	princeps	NOM	_
cui	qui	PROrel	Com
plurimi	multus	ADJqua	Masc
et	et	CONcoo	_
acerrimi	acer	ADJqua	Masc
comites	comes	NOM	_

sordes	sordes	NOM	_
omnium	omnis	PROind	Com
ac	ac	CONcoo	_
torpor	torpor	NOM	_
procerum	procer	NOM	_

haec	hic	PROdem	Neut
in	in	PRE	_
commune	commune	NOM	_
de	de	PRE	_
omnium	omnis	PROind	Com
Germanorum	germani	NOM	_
origine	origo	NOM	_
ac	ac	CONcoo	_
moribus	mos	NOM	_
accepimus	accipio	VER	_
nunc	nunc	ADV	_
singularum	singulus	ADJdis	Fem
gentium	gens	NOM	_
instituta	institutum	NOM	_
ritus	ritus	NOM	_
-que	que	CONcoo	_
quatenus	quatenus	ADVint	_
differant	differo	VER	_
quae	quis	PROint	Fem
-que	que	CONcoo	_
nationes	natio	NOM	_
e	ex	PRE	_
Germania	germania	NOM	_
in	in	PRE	_
Gallias	gallia	NOM	_
commigrauerint	commigro	VER	_
expediam	expedio	VER	_

gens	gens	NOM	_
non	non	ADVneg	_
astuta	astutus	ADJqua	Fem
nec	nec	CONcoo	_
callida	callidus	ADJqua	Fem
aperit	aperio	VER	_
adhuc	adhuc	ADV	_
secreta	secretum	NOM	_
pectoris	pectus	NOM	_
licentia	licentia	NOM	_
loci	locus	NOM	_
ergo	ergo	CONcoo	_
detecta	detectus	ADJqua	Fem
et	et	CONcoo	_
nuda	nudus	ADJqua	Fem
omnium	omnis	PROind	Com
mens	mens	NOM	_

melius	bene	ADV	_
quidem	quidem	ADV	_
adhuc	adhuc	ADV	_
eae	is	PROdem	Fem
ciuitates	ciuitas	NOM	_
in	in	PRE	_
quibus	qui	PROrel	Com
tantum	tantum	ADV	_
uirgines	uirgo	NOM	_
nubunt	nubo	VER	_
et	et	CONcoo	_
cum	cum	PRE	_
spe	spes	NOM	_
uoto	uotum	NOM	_
-que	que	CONcoo	_
uxoris	uxor	NOM	_
semel	semel	ADJadv.mul	_
transigitur	transigo	VER	_

ea	is	PROdem	Fem
-que	que	CONcoo	_
Germaniae	germania	NOM	_
uelut	uelut	ADVrel	_
frons	frons	NOM	_
est	sum	VER	_
quatenus	quatenus	ADVrel	_
Danuuio	danuuius	NOM	_
peragitur	perago	VER	_

nec	nec	CONcoo	_
ulli	ullus	PROind	Com
auspicio	auspicium	NOM	_
maior	magnus	ADJqua	MascFem
fides	fides	NOM	_
non	non	ADVneg	_
solum	solum	ADV	_
apud	apud	PRE	_
plebem	plebs	NOM	_
apud	apud	PRE	_
proceres	procer	NOM	_
apud	apud	PRE	_
sacerdotes	sacerdos	NOM	_
se	sui	PROref	_
enim	enim	CONcoo	_
ministros	minister	NOM	_
deorum	deus	NOM	_
illos	ille	PROdem	Masc
conscios	conscius	ADJqua	Masc
putant	puto	VER	_

notum	notus	ADJqua	MascNeut
ignotum	ignotus	ADJqua	MascNeut
-que	que	CONcoo	_
quantum	quantum	ADVrel	_
ad	ad	PRE	_
ius	ius	NOM	_
hospitis	hospes	NOM	_
nemo	nemo	PROind	_
discernit	discerno	VER	_

proximi	propior	ADJqua	Masc
Chattis	chatti	NOM	_
certum	certus	ADJqua	MascNeut
iam	iam	ADV	_
alueo	alueus	NOM	_
Rhenum	rhenus	NOM	_
qui	qui	PROrel	Masc
-que	que	CONcoo	_
terminus	terminus	NOM	_
esse	sum	VER	_
sufficiat	sufficio	VER	_
Vsipi	usipi	NOM	_
ac	ac	CONcoo	_
Tencteri	tencteri	NOM	_
colunt	colo	VER	_

quantulum	quantulum	ADVint	_
enim	enim	CONcoo	_
amnis	amnis	NOM	_
obstabat	obsto	VER	_
quominus	quominus	CONsub	_
ut	ut	ADVrel	_
quaeque	quisque	PROind	Fem
gens	gens	NOM	_
eualuerat	eualesco	VER	_
occuparet	occupo	VER	_
permutaret	permuto	VER	_
-que	que	CONcoo	_
sedes	sedes	NOM	_
promiscuas	promiscuus	ADJqua	Fem
adhuc	adhuc	ADV	_
et	et	CONcoo	_
nulla	nullus	PROind	Fem
regnorum	regnum	NOM	_
potentia	potentia	NOM	_
diuisas	diuido	VER	Fem

tracti	traho	VER	Masc
ruina	ruina	NOM	_
Cheruscorum	cherusci	NOM	_
et	et	ADV	_
Fosi	fosi	NOM	_
contermina	conterminus	ADJqua	Fem
gens	gens	NOM	_
aduersarum	aduersus	ADJqua	Fem
rerum	res	NOM	_
ex	ex	PRE	_
aequo	aequum	NOM	_
socii	socius	NOM	_
sunt	sum	VER	_
cum	cum	CONsub	_
in	in	PRE	_
secundis	secundus	ADJqua	Com
minores	paruus	ADJqua	MascFem
fuissent	sum	VER	_

unde	unde	ADVrel	_
habitus	habitus	NOM	_
quoque	quoque	ADV	_
corporum	corpus	NOM	_
tamquam	tamquam	ADVrel	_
in	in	PRE	_
tanto	tantus	PROdem	MascNeut
hominum	homo	NOM	_
numero	numerus	NOM	_
idem	idem	PROdem	MascNeut
omnibus	omnis	PROind	Com
truces	trux	ADJqua	MascFem
et	et	CONcoo	_
caerulei	caeruleus	ADJqua	Masc
oculi	oculus	NOM	_
rutilae	rutilus	ADJqua	Fem
comae	coma	NOM	_
magna	magnus	ADJqua	Neut
corpora	corpus	NOM	_
et	et	CONcoo	_
tantum	tantum	ADV	_
ad	ad	PRE	_
impetum	impetus	NOM	_
ualida	ualidus	ADJqua	Neut

sic	sic	ADV	_
uiuendum	uiuo	VER	MascNeut
sic	sic	ADV	_
pereundum	pereo	VER	MascNeut
accipere	accipio	VER	_
se	sui	PROref	_
quae	qui	PROrel	Neut
liberis	liberi	NOM	_
inuiolata	inuiolatus	ADJqua	Neut
ac	ac	CONcoo	_
digna	dignus	ADJqua	Neut
reddat	reddo	VER	_
quae	qui	PROrel	Neut
nurus	nurus	NOM	_
accipiant	accipio	VER	_
rursus	rursus	ADV	_
-que	que	CONcoo	_
ad	ad	PRE	_
nepotes	nepos	NOM	_
referantur	refero	VER	_

laeti	laetus	ADJqua	Fem
tunc	tunc	ADV	_
dies	dies	NOM	_
festa	festus	ADJqua	Neut
loca	locus	NOM	_
quaecumque	quicumque	PROrel	Neut
aduentu	aduentus	NOM	_
hospitio	hospitium	NOM	_
-que	que	CONcoo	_
dignatur	dignor	VER	_

multum	multum	NOM	_
ut	ut	ADVrel	_
inter	inter	PRE	_
Germanos	germani	NOM	_
rationis	ratio	NOM	_
ac	ac	CONcoo	_
sollertiae	sollertia	NOM	_
praeponere	praepono	VER	_
electos	electus	ADJqua	Masc
audire	audio	VER	_
praepositos	praepono	VER	Masc
nosse	nosco	VER	_
ordines	ordo	NOM	_
intellegere	intelligo	VER	_
occasiones	occasio	NOM	_
differre	differo	VER	_
impetus	impetus	NOM	_
disponere	dispono	VER	_
diem	dies	NOM	_
uallare	uallo	VER	_
noctem	nox	NOM	_
fortunam	fortuna	NOM	_
inter	inter	PRE	_
dubia	dubius	ADJqua	Neut
uirtutem	uirtus	NOM	_
inter	inter	PRE	_
certa	certus	ADJqua	Neut
numerare	numero	VER	_
quod	qui	PROrel	Neut
-que	que	CONcoo	_
rarissimum	rarus	ADJqua	Neut
nec	nec	CONcoo	_
nisi	nisi	CONsub	_
Romanae	romanus	ADJqua	Fem
disciplinae	disciplina	NOM	_
concessum	concedo	VER	Neut
plus	multum	ADV	_
reponere	repono	VER	_
in	in	PRE	_
duce	dux	NOM	_
quam	quam	ADVrel	_
in	in	PRE	_
exercitu	exercitus	NOM	_

Marcomanis	marcomani	NOM	_
Quadis	quadi	NOM	_
-que	que	CONcoo	_
usque	usque	ADV	_
ad	ad	PRE	_
nostram	noster	PROpos	Fem
memoriam	memoria	NOM	_
reges	rex	NOM	_
manserunt	maneo	VER	_
ex	ex	PRE	_
gente	gens	NOM	_
ipsorum	ipse	PROdem	MascNeut
nobile	nobilis	ADJqua	Neut
Marobodui	maroboduus	NOM	_
et	et	CONcoo	_
Tudri	tuder	NOM	_
genus	genus	NOM	_
iam	iam	ADV	_
et	et	ADV	_
externos	externus	ADJqua	Masc
patiuntur	patior	VER	_
sed	sed	CONcoo	_
uis	uis	NOM	_
et	et	CONcoo	_
potentia	potentia	NOM	_
regibus	rex	NOM	_
ex	ex	PRE	_
auctoritate	auctoritas	NOM	_
Romana	romanus	ADJqua	Fem

silentium	silentium	NOM	_
per	per	PRE	_
sacerdotes	sacerdos	NOM	_
quibus	qui	PROrel	Com
tum	tum	ADV	_
et	et	ADV	_
coercendi	coerceo	VER	_
ius	ius	NOM	_
est	sum	VER	_
imperatur	impero	VER	_

nulli	nullus	PROind	Com
domus	domus	NOM	_
aut	aut	CONcoo	_
ager	ager	NOM	_
aut	aut	CONcoo	_
aliqua	aliquis	PROind	Fem
cura	cura	NOM	_
prout	prout	ADVrel	_
ad	ad	PRE	_
quemque	quisque	PROind	Masc
uenere	uenio	VER	_
aluntur	alo	VER	_
prodigi	prodigus	ADJqua	Masc
alieni	alienum	NOM	_
contemptores	contemptor	NOM	_
sui	suum	NOM	_
donec	donec	CONsub	_
exsanguis	exsanguis	ADJqua	Fem
senectus	senectus	NOM	_
tam	tam	ADV	_
durae	durus	ADJqua	Fem
uirtuti	uirtus	NOM	_
impares	impar	ADJqua	MascFem
faciat	facio	VER	_

publice	publice	ADV	_
aluntur	alo	VER	_
iisdem	idem	PROdem	Com
nemoribus	nemus	NOM	_
ac	ac	CONcoo	_
lucis	lucus	NOM	_
candidi	candidus	ADJqua	Masc
et	et	CONcoo	_
nullo	nullus	PROind	MascNeut
mortali	mortalis	ADJqua	Com
opere	opus	NOM	_
contacti	contingo	VER	Masc
quos	qui	PROrel	Masc
pressos	premo	VER	Masc
sacro	sacer	ADJqua	MascNeut
curru	currus	NOM	_
sacerdos	sacerdos	NOM	_
ac	ac	CONcoo	_
rex	rex	NOM	_
uel	uel	CONcoo	_
princeps	princeps	NOM	_
ciuitatis	ciuitas	NOM	_
comitantur	comitor	VER	_
hinnitus	hinnitus	NOM	_
-que	que	CONcoo	_
ac	ac	CONcoo	_
fremitus	fremitus	NOM	_
obseruant	obseruo	VER	_

hi	hic	PROdem	Masc
tamen	tamen	ADV	_
inter	inter	PRE	_
Germanos	germani	NOM	_
potius	potius	ADV	_
referuntur	refero	VER	_
quia	quia	CONsub	_
et	et	CONcoo	_
domos	domus	NOM	_
figunt	figo	VER	_
et	et	CONcoo	_
scuta	scutum	NOM	_
gestant	gesto	VER	_
et	et	CONcoo	_
pedum	pes	NOM	_
usu	usus	NOM	_
ac	ac	CONcoo	_
pernicitate	pernicitas	NOM	_
gaudent	gaudeo	VER	_
quae	qui	PROrel	Neut
omnia	omnis	PROind	Neut
diuersa	diuersus	ADJqua	Neut
Sarmatis	sarmatae	NOM	_
sunt	sum	VER	_
in	in	PRE	_
plaustro	plaustrum	NOM	_
equo	equus	NOM	_
-que	que	CONcoo	_
uiuentibus	uiuo	VER	Com

eundem	idem	PROdem	Masc
Germaniae	germania	NOM	_
sinum	sinus	NOM	_
proximi	propior	ADJqua	Masc
Oceano	oceanus	NOM	_
Cimbri	cimbri	NOM	_
tenent	teneo	VER	_
parua	paruus	ADJqua	Fem
nunc	nunc	ADV	_
ciuitas	ciuitas	NOM	_
sed	sed	CONcoo	_
gloria	gloria	NOM	_
ingens	ingens	ADJqua	Com

in	in	PRE	_
aliis	alius	PROind	Com
gentibus	gens	NOM	_
seu	seu	CONcoo	_
cognatione	cognatio	NOM	_
aliqua	aliquis	PROind	Fem
Sueborum	suebi	NOM	_
seu	seu	CONcoo	_
quod	qui	PROrel	Neut
saepe	saepe	ADV	_
accidit	accido	VER	_
imitatione	imitatio	NOM	_
rarum	rarus	ADJqua	Neut
et	et	CONcoo	_
intra	intra	PRE	_
iuuentae	iuuenta	NOM	_
spatium	spatium	NOM	_
apud	apud	PRE	_
Suebos	suebi	NOM	_
usque	usque	ADV	_
ad	ad	PRE	_
canitiem	canities	NOM	_
horrentem	horreo	VER	MascFem
capillum	capillus	NOM	_
retro	retro	ADV	_
sequuntur	sequor	VER	_
ac	ac	CONcoo	_
saepe	saepe	ADV	_
in	in	PRE	_
ipso	ipse	PROdem	MascNeut
uertice	uertex	NOM	_
religant	religo	VER	_
principes	princeps	NOM	_
et	et	ADV	_
ornatiorem	ornatus	ADJqua	MascFem
habent	habeo	VER	_

hactenus	hactenus	ADV	_
in	in	PRE	_
occidentem	occidens	NOM	_
Germaniam	germania	NOM	_
nouimus	nosco	VER	_
in	in	PRE	_
septentrionem	septentrio	NOM	_
ingenti	ingens	ADJqua	Com
flexu	flexus	NOM	_
redit	redeo	VER	_

possessione	possessio	NOM	_
et	et	CONcoo	_
usu	usus	NOM	_
haud	haud	ADVneg	_
perinde	perinde	ADV	_
afficiuntur	afficio	VER	_

cibi	cibus	NOM	_
simplices	simplex	ADJmul	MascFem
agrestia	agrestis	ADJqua	Neut
poma	pomum	NOM	_
recens	recens	ADJqua	Com
fera	fera	NOM	_
aut	aut	CONcoo	_
lac	lac	NOM	_
concretum	concretus	ADJqua	Neut
sine	sine	PRE	_
apparatu	apparatus	NOM	_
sine	sine	PRE	_
blandimentis	blandimentum	NOM	_
expellunt	expello	VER	_
famem	fames	NOM	_

cum	cum	CONsub	_
defecere	deficio	VER	_
qui	qui	PROrel	Masc
modo	modo	ADV	_
hospes	hospes	NOM	_
fuerat	sum	VER	_
monstrator	monstrator	NOM	_
hospitii	hospitium	NOM	_
et	et	CONcoo	_
comes	comes	NOM	_
proximam	propior	ADJqua	Fem
domum	domus	NOM	_
non	non	ADVneg	_
inuitati	inuito	VER	Masc
adeunt	adeo	VER	_

sic	sic	ADV	_
unum	unus	ADJcar	MascNeut
accipiunt	accipio	VER	_
maritum	maritus	NOM	_
quomodo	quomodo	ADVrel	_
unum	unus	ADJcar	MascNeut
corpus	corpus	NOM	_
unam	unus	ADJcar	Fem
-que	que	CONcoo	_
uitam	uita	NOM	_
ne	ne	CONsub	_
ulla	ullus	PROind	Fem
cogitatio	cogitatio	NOM	_
ultra	ultra	ADV	_
ne	ne	CONsub	_
longior	longus	ADJqua	MascFem
cupiditas	cupiditas	NOM	_
ne	ne	CONsub	_
tamquam	tamquam	ADVrel	_
maritum	maritus	NOM	_
sed	sed	CONcoo	_
tamquam	tamquam	ADVrel	_
matrimonium	matrimonium	NOM	_
ament	amo	VER	_

faenus	faenus	NOM	_
agitare	agito	VER	_
et	et	CONcoo	_
in	in	PRE	_
usuras	usura	NOM	_
extendere	extendo	VER	_
ignotum	ignotus	ADJqua	Neut
ideo	ideo	ADV	_
-que	que	CONcoo	_
magis	magis	ADV	_
seruatur	seruo	VER	_
quam	quam	ADVrel	_
si	si	CONsub	_
uetitum	ueto	VER	Neut

sic	sic	ADV	_
instituere	instituo	VER	_
maiores	magnus	ADJqua	MascFem
posteri	posteri	NOM	_
imitantur	imitor	VER	_

haec	hic	PROdem	Fem
dignitas	dignitas	NOM	_
hae	hic	PROdem	Fem
uires	uis	NOM	_
magno	magnus	ADJqua	MascNeut
semper	semper	ADV	_
et	et	CONcoo	_
electorum	electus	ADJqua	MascNeut
iuuenum	iuuenis	NOM	_
globo	globus	NOM	_
circumdari	circumdo	VER	_
in	in	PRE	_
pace	pax	NOM	_
decus	decus	NOM	_
in	in	PRE	_
bello	bellum	NOM	_
praesidium	praesidium	NOM	_

celebrant	celebro	VER	_
carminibus	carmen	NOM	_
antiquis	antiquus	ADJqua	Com
quod	qui	PROrel	Neut
unum	unus	ADJcar	Neut
apud	apud	PRE	_
illos	ille	PROdem	Masc
memoriae	memoria	NOM	_
et	et	CONcoo	_
annalium	annalis	NOM	_
genus	genus	NOM	_
est	sum	VER	_
Tuistonem	tuisto	NOM	_
deum	deus	NOM	_
terra	terra	NOM	_
editum	edo	VER	MascNeut

corpora	corpus	NOM	_
suorum	sui	PROpos.ref	MascNeut
etiam	etiam	ADV	_
in	in	PRE	_
dubiis	dubius	ADJqua	Com
proeliis	proelium	NOM	_
referunt	refero	VER	_

seruos	seruus	NOM	_
condicionis	condicio	NOM	_
huius	hic	PROdem	Com
per	per	PRE	_
commercia	commercium	NOM	_
tradunt	trado	VER	_
ut	ut	CONsub	_
se	sui	PROref	_
quoque	quoque	ADV	_
pudore	pudor	NOM	_
uictoriae	uictoria	NOM	_
exsoluant	exsoluo	VER	_

sed	sed	CONcoo	_
utrum	utrum	ADVint	_
Arauisci	arauisci	NOM	_
in	in	PRE	_
Pannoniam	pannonia	NOM	_
ab	ab	PRE	_
Osis	osi	NOM	_
Germanorum	germani	NOM	_
natione	natio	NOM	_
an	an	ADVint	_
Osi	osi	NOM	_
ab	ab	PRE	_
Arauiscis	arauisci	NOM	_
in	in	PRE	_
Germaniam	germania	NOM	_
commigrauerint	commigro	VER	_
cum	cum	CONsub	_
eodem	idem	PROdem	MascNeut
adhuc	adhuc	ADV	_
sermone	sermo	NOM	_
institutis	institutum	NOM	_
moribus	mos	NOM	_
utantur	utor	VER	_
incertum	incertus	ADJqua	Neut
est	sum	VER	_
quia	quia	CONsub	_
pari	par	ADJqua	Com
olim	olim	ADV	_
inopia	inopia	NOM	_
ac	ac	CONcoo	_
libertate	libertas	NOM	_
eadem	idem	PROdem	Neut
utriusque	uterque	PROind	Com
ripae	ripa	NOM	_
bona	bonum	NOM	_
mala	malum	NOM	_
-que	que	CONcoo	_
erant	sum	VER	_

est	sum	VER	_
apud	apud	PRE	_
illos	ille	PROdem	Masc
et	et	ADV	_
opibus	ops	NOM	_
honos	honor	NOM	_
eo	eo	ADV	_
-que	que	CONcoo	_
unus	unus	ADJcar	Masc
imperitat	imperito	VER	_
nullis	nullus	PROind	Com
iam	iam	ADV	_
exceptionibus	exceptio	NOM	_
non	non	ADVneg	_
precario	precarius	ADJqua	MascNeut
iure	ius	NOM	_
parendi	pareo	VER	_

ibi	ibi	ADV	_
enim	enim	CONcoo	_
et	et	CONcoo	_
super	super	PRE	_
ingenuos	ingenuus	ADJqua	Masc
et	et	CONcoo	_
super	super	PRE	_
nobiles	nobilis	NOM	_
ascendunt	ascendo	VER	_
apud	apud	PRE	_
ceteros	ceteri	NOM	_
impares	impar	ADJqua	MascFem
libertini	libertinus	NOM	_
libertatis	libertas	NOM	_
argumentum	argumentum	NOM	_
sunt	sum	VER	_

nunc	nunc	ADV	_
de	de	PRE	_
Suebis	suebi	NOM	_
dicendum	dico	VER	Neut
est	sum	VER	_
quorum	qui	PROrel	MascNeut
non	non	ADVneg	_
una	unus	ADJcar	Fem
ut	ut	ADVrel	_
Chattorum	chatti	NOM	_
Tencterorum	tencteri	NOM	_
-ue	ue	CONcoo	_
gens	gens	NOM	_
maiorem	magnus	ADJqua	MascFem
enim	enim	CONcoo	_
Germaniae	germania	NOM	_
partem	pars	NOM	_
obtinent	obtineo	VER	_
propriis	proprius	ADJqua	Com
adhuc	adhuc	ADV	_
nationibus	natio	NOM	_
nominibus	nomen	NOM	_
-que	que	CONcoo	_
discreti	discerno	VER	Masc
quamquam	quamquam	CONsub	_
in	in	PRE	_
commune	commune	NOM	_
Suebi	suebi	NOM	_
uocentur	uoco	VER	_

heredes	heres	NOM	_
tamen	tamen	ADV	_
successores	successor	NOM	_
-que	que	CONcoo	_
sui	suus	PROpos.ref	Masc
cuique	quisque	PROind	Com
liberi	liberi	NOM	_
et	et	CONcoo	_
nullum	nullus	PROind	Neut
testamentum	testamentum	NOM	_

rari	rarus	ADJqua	Masc
excursus	excursus	NOM	_
et	et	CONcoo	_
fortuita	fortuitus	ADJqua	Fem
pugna	pugna	NOM	_

arcanus	arcanus	ADJqua	Masc
hinc	hinc	ADV	_
terror	terror	NOM	_
sancta	sanctus	ADJqua	Fem
-que	que	CONcoo	_
ignorantia	ignorantia	NOM	_
quid	quis	PROint	Neut
sit	sum	VER	_
illud	ille	PROdem	Neut
quod	qui	PROrel	Neut
tantum	tantum	ADV	_
perituri	pereo	VER	Masc
uident	uideo	VER	_

praecipua	praecipuus	ADJqua	Fem
Marcomanorum	marcomani	NOM	_
gloria	gloria	NOM	_
uires	uis	NOM	_
-que	que	CONcoo	_
atque	atque	CONcoo	_
ipsa	ipse	PROdem	Fem
etiam	etiam	ADV	_
sedes	sedes	NOM	_
pulsis	pello	VER	Com
olim	olim	ADV	_
Boiis	boii	NOM	_
uirtute	uirtus	NOM	_
parta	pario	VER	Fem

liberti	libertus	NOM	_
non	non	ADVneg	_
multum	multum	ADV	_
supra	supra	PRE	_
seruos	seruus	NOM	_
sunt	sum	VER	_
raro	raro	ADV	_
aliquod	aliquis	PROind	Neut
momentum	momentum	NOM	_
in	in	PRE	_
domo	domus	NOM	_
numquam	numquam	ADVneg	_
in	in	PRE	_
ciuitate	ciuitas	NOM	_
exceptis	excipio	VER	Com
dumtaxat	dumtaxat	ADV	_
iis	is	PROdem	Com
gentibus	gens	NOM	_
quae	qui	PROrel	Fem
regnantur	regno	VER	_

nec	nec	CONcoo	_
defuit	desum	VER	_
audentia	audentia	NOM	_
Druso	drusus	NOM	_
Germanico	germanicus	NOM	_
sed	sed	CONcoo	_
obstitit	obsisto	VER	_
Oceanus	oceanus	NOM	_
in	in	PRE	_
se	sui	PROref	_
simulatque	simulatque	CONsub	_
in	in	PRE	_
Herculem	hercules	NOM	_
inquiri	inquiro	VER	_

nec	nec	CONcoo	_
alius	alius	PROind	Masc
feminis	femina	NOM	_
quam	quam	ADVrel	_
uiris	uir	NOM	_
habitus	habitus	NOM	_
nisi	nisi	CONsub	_
quod	quod	CONsub	_
feminae	femina	NOM	_
saepius	saepe	ADV	_
lineis	lineus	ADJqua	Com
amictibus	amictus	NOM	_
uelantur	uelo	VER	_
eos	is	PROdem	Masc
-que	que	CONcoo	_
purpura	purpura	NOM	_
uariant	uario	VER	_
partem	pars	NOM	_
-que	que	CONcoo	_
uestitus	uestitus	NOM	_
superioris	superus	ADJqua	MascFem
in	in	PRE	_
manicas	manica	NOM	_
non	non	ADVneg	_
extendunt	extendo	VER	_
nudae	nudus	ADJqua	Fem
brachia	brachium	NOM	_
ac	ac	CONcoo	_
lacertos	lacertus	NOM	_
sed	sed	CONcoo	_
et	et	ADV	_
proxima	propior	ADJqua	Fem
pars	pars	NOM	_
pectoris	pectus	NOM	_
patet	pateo	VER	_

sed	sed	CONcoo	_
et	et	ADV	_
leuioribus	leuis	ADJqua	Com
delictis	delictum	NOM	_
pro	pro	PRE	_
modo	modus	NOM	_
poena	poena	NOM	_
equorum	equus	NOM	_
pecorum	pecus	NOM	_
-que	que	CONcoo	_
numero	numerus	NOM	_
conuicti	conuinco	VER	Masc
multantur	multo	VER	_

medio	medius	ADJqua	MascNeut
tam	tam	ADV	_
longi	longus	ADJqua	MascNeut
aeui	aeuum	NOM	_
spatio	spatium	NOM	_
multa	multus	ADJqua	Neut
inuicem	inuicem	ADV	_
damna	damnum	NOM	_

retro	retro	ADV	_
Marsigni	marsigni	NOM	_
Cotini	cotini	NOM	_
Osi	osi	NOM	_
Buri	buri	NOM	_
terga	tergum	NOM	_
Marcomanorum	marcomani	NOM	_
Quadorum	quadi	NOM	_
-que	que	CONcoo	_
claudunt	claudo	VER	_

sera	serus	ADJqua	Fem
iuuenum	iuuenis	NOM	_
uenus	uenus	NOM	_
eo	eo	ADV	_
-que	que	CONcoo	_
inexhausta	inexhaustus	ADJqua	Fem
pubertas	pubertas	NOM	_

quotiens	quotiens	ADVrel	_
bella	bellum	NOM	_
non	non	ADVneg	_
ineunt	ineo	VER	_
multum	multum	ADV	_
uenatibus	uenatus	NOM	_
plus	multum	ADV	_
per	per	PRE	_
otium	otium	NOM	_
transigunt	transigo	VER	_
dediti	deditus	ADJqua	Masc
somno	somnus	NOM	_
cibo	cibus	NOM	_
-que	que	CONcoo	_
fortissimus	fortis	ADJqua	Masc
quisque	quisque	PROind	Masc
ac	ac	CONcoo	_
bellicosissimus	bellicosus	ADJqua	Masc
nihil	nihil	PROind	_
agens	ago	VER	Com
delegata	delego	VER	Fem
domus	domus	NOM	_
et	et	CONcoo	_
penatium	penates	NOM	_
et	et	CONcoo	_
agrorum	ager	NOM	_
cura	cura	NOM	_
feminis	femina	NOM	_
senibus	senex	NOM	_
-que	que	CONcoo	_
et	et	CONcoo	_
infirmissimo	infirmus	ADJqua	MascNeut
cuique	quisque	PROind	Com
ex	ex	PRE	_
familia	familia	NOM	_
ipsi	ipse	PROdem	Masc
hebent	hebeo	VER	_
mira	mirus	ADJqua	Fem
diuersitate	diuersitas	NOM	_
naturae	natura	NOM	_
cum	cum	CONsub	_
iidem	idem	PROdem	Masc
homines	homo	NOM	_
sic	sic	ADV	_
ament	amo	VER	_
inertiam	inertia	NOM	_
et	et	CONcoo	_
oderint	odi	VER	_
quietem	quies	NOM	_

sucum	sucus	NOM	_
tamen	tamen	ADV	_
arborum	arbor	NOM	_
esse	sum	VER	_
intellegas	intelligo	VER	_
quia	quia	CONsub	_
terrena	terrenus	ADJqua	Neut
quaedam	quidam	PROind	Neut
atque	atque	CONcoo	_
etiam	etiam	ADV	_
uolucria	uolucer	ADJqua	Neut
animalia	animal	NOM	_
plerumque	plerumque	ADV	_
interlucent	interluceo	VER	_
quae	qui	PROrel	Neut
implicata	implico	VER	Neut
humore	humor	NOM	_
mox	mox	ADV	_
durescente	duresco	VER	Com
materia	materia	NOM	_
cluduntur	cludo	VER	_

ne	ne	ADVneg	_
armentis	armentum	NOM	_
quidem	quidem	ADV	_
suus	suus	PROpos.ref	Masc
honor	honor	NOM	_
aut	aut	CONcoo	_
gloria	gloria	NOM	_
frontis	frons	NOM	_
numero	numerus	NOM	_
gaudent	gaudeo	VER	_
eae	is	PROdem	Fem
-que	que	CONcoo	_
solae	solus	PROind	Fem
et	et	CONcoo	_
gratissimae	gratus	ADJqua	Fem
opes	ops	NOM	_
sunt	sum	VER	_

utraeque	uterque	PROind	Fem
nationes	natio	NOM	_
usque	usque	ADV	_
ad	ad	PRE	_
Oceanum	oceanus	NOM	_
Rheno	rhenus	NOM	_
praetexuntur	praetexo	VER	_
ambiunt	ambio	VER	_
-que	que	CONcoo	_
inmensos	immensus	ADJqua	Masc
insuper	insuper	ADV	_
lacus	lacus	NOM	_
et	et	CONcoo	_
Romanis	romanus	ADJqua	Com
classibus	classis	NOM	_
nauigatos	nauigo	VER	Masc

nec	nec	CONcoo	_
dierum	dies	NOM	_
numerum	numerus	NOM	_
ut	ut	ADVrel	_
nos	nos	PROper	_
sed	sed	CONcoo	_
noctium	nox	NOM	_
computant	computo	VER	_

maneat	maneo	VER	_
quaeso	quaeso	VER	_
duret	duro	VER	_
-que	que	CONcoo	_
gentibus	gens	NOM	_
si	si	CONsub	_
non	non	ADVneg	_
amor	amor	NOM	_
nostri	nos	PROper	_
at	at	CONcoo	_
certe	certe	ADV	_
odium	odium	NOM	_
sui	sui	PROref	_
quando	quando	CONsub	_
urgentibus	urgeo	VER	Com
imperii	imperium	NOM	_
fatis	fatum	NOM	_
nihil	nihil	PROind	_
iam	iam	ADV	_
praestare	praesto	VER	_
fortuna	fortuna	NOM	_
maius	magnus	ADJqua	Neut
potest	possum	VER	_
quam	quam	ADVrel	_
hostium	hostis	NOM	_
discordiam	discordia	NOM	_

ne	ne	ADVneg	_
ferrum	ferrum	NOM	_
quidem	quidem	ADV	_
superest	supersum	VER	_
sicut	sicut	ADVrel	_
ex	ex	PRE	_
genere	genus	NOM	_
telorum	telum	NOM	_
colligitur	colligo	VER	_

sed	sed	CONcoo	_
arma	arma	NOM	_
sumere	sumo	VER	_
non	non	ADVneg	_
cuiquam	quisquam	PROind	Com
moris	mos	NOM	_
quam	antequam	CONsub	_
ciuitas	ciuitas	NOM	_
suffecturum	sufficio	VER	MascNeut
probauerit	probo	VER	_

nec	nec	CONcoo	_
uirgines	uirgo	NOM	_
festinantur	festino	VER	_
eadem	idem	PROdem	Fem
iuuenta	iuuenta	NOM	_
similis	similis	ADJqua	MascFem
proceritas	proceritas	NOM	_
pares	par	ADJqua	MascFem
ualidae	ualidus	ADJqua	Fem
-que	que	CONcoo	_
miscentur	misceo	VER	_
ac	ac	CONcoo	_
robora	robur	NOM	_
parentum	parens	NOM	_
liberi	liberi	NOM	_
referunt	refero	VER	_

si	si	CONsub	_
prohibuerunt	prohibeo	VER	_
nulla	nullus	PROind	Fem
de	de	PRE	_
eadem	idem	PROdem	Fem
re	res	NOM	_
in	in	PRE	_
eundem	idem	PROdem	Masc
diem	dies	NOM	_
consultatio	consultatio	NOM	_
sin	sin	CONsub	_
permissum	permitto	VER	Neut
auspiciorum	auspicium	NOM	_
adhuc	adhuc	ADV	_
fides	fides	NOM	_
exigitur	exigo	VER	_

super	super	PRE	_
sanguinem	sanguis	NOM	_
et	et	CONcoo	_
spolia	spolium	NOM	_
reuelant	reuelo	VER	_
frontem	frons	NOM	_
se	sui	PROref	_
-que	que	CONcoo	_
tum	tum	ADV	_
demum	demum	ADV	_
pretia	pretium	NOM	_
nascendi	nascor	VER	_
rettulisse	refero	VER	_
dignos	dignus	ADJqua	Masc
-que	que	CONcoo	_
patria	patria	NOM	_
ac	ac	CONcoo	_
parentibus	parens	NOM	_
ferunt	fero	VER	_
ignauis	ignauus	NOM	_
et	et	CONcoo	_
imbellibus	imbellis	ADJqua	Com
manet	maneo	VER	_
squalor	squalor	NOM	_

Martem	mars	NOM	_
concessis	concedo	VER	Com
animalibus	animal	NOM	_
placant	placo	VER	_

ne	ne	ADVneg	_
Vbii	ubii	NOM	_
quidem	quidem	ADV	_
quamquam	quamquam	CONsub	_
Romana	romanus	ADJqua	Fem
colonia	colonia	NOM	_
esse	sum	VER	_
meruerint	mereo	VER	_
ac	ac	CONcoo	_
libentius	libenter	ADV	_
Agrippinenses	agrippinenses	NOM	_
conditoris	conditor	NOM	_
sui	suus	PROpos.ref	MascNeut
nomine	nomen	NOM	_
uocentur	uoco	VER	_
origine	origo	NOM	_
erubescunt	erubesco	VER	_
transgressi	transgredior	VER	Masc
olim	olim	ADV	_
et	et	CONcoo	_
experimento	experimentum	NOM	_
fidei	fides	NOM	_
super	super	PRE	_
ipsam	ipse	PROdem	Fem
Rheni	rhenus	NOM	_
ripam	ripa	NOM	_
collocati	colloco	VER	Masc
ut	ut	CONsub	_
arcerent	arceo	VER	_
non	non	ADVneg	_
ut	ut	CONsub	_
custodirentur	custodio	VER	_

Fennis	fenni	NOM	_
mira	mirus	ADJqua	Fem
feritas	feritas	NOM	_
foeda	foedus	ADJqua	Fem
paupertas	paupertas	NOM	_
non	non	ADVneg	_
arma	arma	NOM	_
non	non	ADVneg	_
equi	equus	NOM	_
non	non	ADVneg	_
penates	penates	NOM	_
uictui	uictus	NOM	_
herba	herba	NOM	_
uestitui	uestitus	NOM	_
pelles	pellis	NOM	_
cubile	cubile	NOM	_
humus	humus	NOM	_
solae	solus	PROind	Fem
in	in	PRE	_
sagittis	sagitta	NOM	_
spes	spes	NOM	_
quas	qui	PROrel	Fem
inopia	inopia	NOM	_
ferri	ferrum	NOM	_
ossibus	os	NOM	_
asperant	aspero	VER	_

Tencteri	tencteri	NOM	_
super	super	PRE	_
solitum	solitus	ADJqua	MascNeut
bellorum	bellum	NOM	_
decus	decus	NOM	_
equestris	equester	ADJqua	Com
disciplinae	disciplina	NOM	_
arte	ars	NOM	_
praecellunt	praecello	VER	_
nec	nec	CONcoo	_
maior	magnus	ADJqua	MascFem
apud	apud	PRE	_
Chattos	chatti	NOM	_
peditum	pedes	NOM	_
laus	laus	NOM	_
quam	quam	ADVrel	_
Tencteris	tencteri	NOM	_
equitum	eques	NOM	_

nec	nec	CONcoo	_
quae	quis	PROint	Fem
natura	natura	NOM	_
quae	quis	PROint	Fem
-ue	ue	CONcoo	_
ratio	ratio	NOM	_
gignat	gigno	VER	_
ut	ut	ADVrel	_
barbaris	barbarus	NOM	_
quaesitum	quaero	VER	Neut
compertum	comperio	VER	Neut
-ue	ue	CONcoo	_
diu	diu	ADV	_
quin	quin	ADV	_
etiam	etiam	ADV	_
inter	inter	PRE	_
cetera	ceterus	ADJqua	Neut
eiectamenta	eiectamentum	NOM	_
maris	mare	NOM	_
iacebat	iaceo	VER	_
donec	donec	CONsub	_
luxuria	luxuria	NOM	_
nostra	noster	PROpos	Fem
dedit	do	VER	_
nomen	nomen	NOM	_

Venethi	uenethi	NOM	_
multum	multum	NOM	_
ex	ex	PRE	_
moribus	mos	NOM	_
traxerunt	traho	VER	_
nam	nam	CONcoo	_
quicquid	quisquis	PROrel	Neut
inter	inter	PRE	_
Peucinos	peucini	NOM	_
Fennos	fenni	NOM	_
-que	que	CONcoo	_
siluarum	silua	NOM	_
ac	ac	CONcoo	_
montium	mons	NOM	_
erigitur	erigo	VER	_
latrociniis	latrocinium	NOM	_
pererrant	pererro	VER	_

maioribus	magnus	ADJqua	Com
minoribus	paruus	ADJqua	Com
-que	que	CONcoo	_
Frisiis	frisii	NOM	_
uocabulum	uocabulum	NOM	_
est	sum	VER	_
ex	ex	PRE	_
modo	modus	NOM	_
uirium	uis	NOM	_

nec	nec	CONcoo	_
Naristi	naristi	NOM	_
Quadi	quadi	NOM	_
-ue	ue	CONcoo	_
degenerant	degenero	VER	_

Treueri	treueri	NOM	_
et	et	CONcoo	_
Neruii	neruii	NOM	_
circa	circa	PRE	_
affectationem	affectatio	NOM	_
Germanicae	germanicus	ADJqua	Fem
originis	origo	NOM	_
ultro	ultro	ADV	_
ambitiosi	ambitiosus	ADJqua	Masc
sunt	sum	VER	_
tamquam	tamquam	CONsub	_
per	per	PRE	_
hanc	hic	PROdem	Fem
gloriam	gloria	NOM	_
sanguinis	sanguis	NOM	_
a	ab	PRE	_
similitudine	similitudo	NOM	_
et	et	CONcoo	_
inertia	inertia	NOM	_
Gallorum	galli	NOM	_
separentur	separo	VER	_

frumenta	frumentum	NOM	_
ceteros	ceterus	ADJqua	Masc
-que	que	CONcoo	_
fructus	fructus	NOM	_
patientius	patienter	ADV	_
quam	quam	ADVrel	_
pro	pro	PRE	_
solita	solitus	ADJqua	Fem
Germanorum	germani	NOM	_
inertia	inertia	NOM	_
laborant	laboro	VER	_

sic	sic	ADV	_
constituunt	constituo	VER	_
sic	sic	ADV	_
condicunt	condico	VER	_
nox	nox	NOM	_
ducere	duco	VER	_
diem	dies	NOM	_
uidetur	uideo	VER	_

quae	qui	PROrel	Neut
neque	neque	CONcoo	_
confirmare	confirmo	VER	_
argumentis	argumentum	NOM	_
neque	neque	CONcoo	_
refellere	refello	VER	_
in	in	PRE	_
animo	animus	NOM	_
est	sum	VER	_
ex	ex	PRE	_
ingenio	ingenium	NOM	_
suo	suus	PROpos.ref	MascNeut
quisque	quisque	PROind	Masc
demat	demo	VER	_
uel	uel	CONcoo	_
addat	addo	VER	_
fidem	fides	NOM	_

est	sum	VER	_
uidere	uideo	VER	_
apud	apud	PRE	_
illos	ille	PROdem	Masc
argentea	argenteus	ADJqua	Neut
uasa	uas	NOM	_
legatis	legatus	NOM	_
et	et	CONcoo	_
principibus	princeps	NOM	_
eorum	is	PROdem	MascNeut
muneri	munus	NOM	_
data	do	VER	Neut
non	non	ADVneg	_
in	in	PRE	_
alia	alius	PROind	Fem
uilitate	uilitas	NOM	_
quam	quam	ADVrel	_
quae	qui	PROrel	Com
humo	humus	NOM	_
finguntur	fingo	VER	_
quamquam	quamquam	ADVrel	_
proximi	propior	ADJqua	Masc
ob	ob	PRE	_
usum	usus	NOM	_
commerciorum	commercium	NOM	_
aurum	aurum	NOM	_
et	et	CONcoo	_
argentum	argentum	NOM	_
in	in	PRE	_
pretio	pretium	NOM	_
habent	habeo	VER	_
formas	forma	NOM	_
-que	que	CONcoo	_
quasdam	quidam	PROind	Fem
nostrae	noster	PROpos	Fem
pecuniae	pecunia	NOM	_
agnoscunt	agnosco	VER	_
atque	atque	CONcoo	_
eligunt	eligo	VER	_
interiores	interior	ADJqua	MascFem
simplicius	simpliciter	ADV	_
et	et	CONcoo	_
antiquius	antique	ADV	_
permutatione	permutatio	NOM	_
mercium	merx	NOM	_
utuntur	utor	VER	_

in	in	PRE	_
uniuersum	uniuersum	NOM	_
aestimanti	aestimo	VER	Com
plus	multum	ADV	_
penes	penes	PRE	_
peditem	pedes	NOM	_
roboris	robur	NOM	_
eo	eo	ADV	_
-que	que	CONcoo	_
mixti	misceo	VER	Masc
proeliantur	proelior	VER	_
apta	aptus	ADJqua	Fem
et	et	CONcoo	_
congruente	congruo	VER	Com
ad	ad	PRE	_
equestrem	equester	ADJqua	MascFem
pugnam	pugna	NOM	_
uelocitate	uelocitas	NOM	_
peditum	pedes	NOM	_
quos	qui	PROrel	Masc
ex	ex	PRE	_
omni	omnis	PROind	Com
iuuentute	iuuentus	NOM	_
delectos	deligo	VER	Masc
ante	ante	PRE	_
aciem	acies	NOM	_
locant	loco	VER	_

quidam	quidam	PROind	Masc
sanctiorem	sanctus	ADJqua	MascFem
artiorem	artus	ADJqua	MascFem
-que	que	CONcoo	_
hunc	hic	PROdem	Masc
nexum	nexus	NOM	_
sanguinis	sanguis	NOM	_
arbitrantur	arbitror	VER	_
et	et	CONcoo	_
in	in	PRE	_
accipiendis	accipio	VER	Com
obsidibus	obses	NOM	_
magis	magis	ADV	_
exigunt	exigo	VER	_
tamquam	tamquam	CONsub	_
et	et	CONcoo	_
animum	animus	NOM	_
firmius	firme	ADV	_
et	et	CONcoo	_
domum	domus	NOM	_
latius	late	ADV	_
teneant	teneo	VER	_

ea	is	PROdem	Fem
est	sum	VER	_
in	in	PRE	_
re	res	NOM	_
praua	prauus	ADJqua	Fem
peruicacia	peruicacia	NOM	_
ipsi	ipse	PROdem	Masc
fidem	fides	NOM	_
uocant	uoco	VER	_

is	is	PROdem	Masc
adesse	assum	VER	_
penetrali	penetrale	NOM	_
deam	dea	NOM	_
intellegit	intelligo	VER	_
uectam	ueho	VER	Fem
-que	que	CONcoo	_
bubus	bos	NOM	_
feminis	femina	NOM	_
multa	multus	ADJqua	Fem
cum	cum	PRE	_
ueneratione	ueneratio	NOM	_
prosequitur	prosequor	VER	_

eo	eo	ADV	_
-que	que	CONcoo	_
omnis	omnis	PROind	MascFem
superstitio	superstitio	NOM	_
respicit	respicio	VER	_
tamquam	tamquam	CONsub	_
inde	inde	ADV	_
initia	initium	NOM	_
gentis	gens	NOM	_
ibi	ibi	ADV	_
regnator	regnator	NOM	_
omnium	omnis	PROind	Com
deus	deus	NOM	_
cetera	cetera	NOM	_
subiecta	subiectus	ADJqua	Neut
atque	atque	CONcoo	_
parentia	pareo	VER	Neut

nemo	nemo	PROind	_
enim	enim	CONcoo	_
illic	illic	ADV	_
uitia	uitium	NOM	_
ridet	rideo	VER	_
nec	nec	CONcoo	_
corrumpere	corrumpo	VER	_
et	et	CONcoo	_
corrumpi	corrumpo	VER	_
saeculum	saeculum	NOM	_
uocatur	uoco	VER	_

sua	suus	PROpos.ref	Fem
quemque	quisque	PROind	Masc
mater	mater	NOM	_
uberibus	uber	NOM	_
alit	alo	VER	_
nec	nec	CONcoo	_
ancillis	ancilla	NOM	_
aut	aut	CONcoo	_
nutricibus	nutrix	NOM	_
delegantur	delego	VER	_

si	si	CONsub	_
naturam	natura	NOM	_
sucini	sucinum	NOM	_
admoto	admoueo	VER	MascNeut
igni	ignis	NOM	_
temptes	tento	VER	_
in	in	PRE	_
modum	modus	NOM	_
taedae	taeda	NOM	_
accenditur	accendo	VER	_
alit	alo	VER	_
-que	que	CONcoo	_
flammam	flamma	NOM	_
pinguem	pinguis	ADJqua	MascFem
et	et	CONcoo	_
olentem	olens	ADJqua	MascFem
mox	mox	ADV	_
ut	ut	ADVrel	_
in	in	PRE	_
picem	pix	NOM	_
resinam	resina	NOM	_
-ue	ue	CONcoo	_
lentescit	lentesco	VER	_

genus	genus	NOM	_
spectaculorum	spectaculum	NOM	_
unum	unus	ADJcar	Neut
atque	atque	CONcoo	_
in	in	PRE	_
omni	omnis	PROind	Com
coetu	coetus	NOM	_
idem	idem	PROdem	MascNeut
nudi	nudus	ADJqua	Masc
iuuenes	iuuenis	NOM	_
quibus	qui	PROrel	Com
id	is	PROdem	Neut
ludicrum	ludicrum	NOM	_
est	sum	VER	_
inter	inter	PRE	_
gladios	gladius	NOM	_
se	sui	PROref	_
atque	atque	CONcoo	_
infestas	infestus	ADJqua	Fem
frameas	framea	NOM	_
saltu	saltus	NOM	_
iaciunt	iacio	VER	_

materia	materia	NOM	_
munificentiae	munificentia	NOM	_
per	per	PRE	_
bella	bellum	NOM	_
et	et	CONcoo	_
raptus	raptus	NOM	_

plurimis	multus	ADJqua	Com
Chattorum	chatti	NOM	_
hic	hic	PROdem	Masc
placet	placeo	VER	_
habitus	habitus	NOM	_
iam	iam	ADV	_
-que	que	CONcoo	_
canent	caneo	VER	_
insignes	insignis	ADJqua	MascFem
et	et	CONcoo	_
hostibus	hostis	NOM	_
simul	simul	ADV	_
suis	sui	PROpos.ref	Com
-que	que	CONcoo	_
monstrati	monstro	VER	Masc

non	non	ADVneg	_
bella	bellum	NOM	_
ineunt	ineo	VER	_
non	non	ADVneg	_
arma	arma	NOM	_
sumunt	sumo	VER	_
clausum	claudo	VER	Neut
omne	omnis	PROind	Neut
ferrum	ferrum	NOM	_
pax	pax	NOM	_
et	et	CONcoo	_
quies	quies	NOM	_
tunc	tunc	ADV	_
tantum	tantum	ADV	_
nota	notus	ADJqua	Fem
tunc	tunc	ADV	_
tantum	tantum	ADV	_
amata	amo	VER	Fem
donec	donec	CONsub	_
idem	idem	PROdem	MascNeut
sacerdos	sacerdos	NOM	_
satiatam	satio	VER	Fem
conuersatione	conuersatio	NOM	_
mortalium	mortalis	NOM	_
deam	dea	NOM	_
templo	templum	NOM	_
reddat	reddo	VER	_

pars	pars	NOM	_
multae	multa	NOM	_
regi	rex	NOM	_
uel	uel	CONcoo	_
ciuitati	ciuitas	NOM	_
pars	pars	NOM	_
ipsi	ipse	PROdem	Com
qui	qui	PROrel	Masc
uindicatur	uindico	VER	_
uel	uel	CONcoo	_
propinquis	propinquus	ADJqua	Com
eius	is	PROdem	Com
exsoluitur	exsoluo	VER	_

ea	is	PROdem	Fem
cura	cura	NOM	_
formae	forma	NOM	_
sed	sed	CONcoo	_
innoxia	innoxius	ADJqua	Fem
neque	neque	CONcoo	_
enim	enim	CONcoo	_
ut	ut	CONsub	_
ament	amo	VER	_
amentur	amo	VER	_
-ue	ue	CONcoo	_
in	in	PRE	_
altitudinem	altitudo	NOM	_
quandam	quidam	PROind	Fem
et	et	CONcoo	_
terrorem	terror	NOM	_
adituri	adeo	VER	Masc
bella	bellum	NOM	_
compti	como	VER	Masc
hostium	hostis	NOM	_
oculis	oculus	NOM	_
ornantur	orno	VER	_

passim	passim	ADV	_
et	et	CONcoo	_
sine	sine	PRE	_
custode	custos	NOM	_
transeunt	transeo	VER	_
et	et	CONcoo	_
cum	cum	CONsub	_
ceteris	ceterus	ADJqua	Com
gentibus	gens	NOM	_
arma	arma	NOM	_
modo	modo	ADV	_
castra	castra	NOM	_
-que	que	CONcoo	_
nostra	noster	PROpos	Neut
ostendamus	ostendo	VER	_
his	hic	PROdem	Com
domos	domus	NOM	_
uillas	uilla	NOM	_
-que	que	CONcoo	_
patefecimus	patefacio	VER	_
non	non	ADVneg	_
concupiscentibus	concupisco	VER	Com

pecuniam	pecunia	NOM	_
probant	probo	VER	_
ueterem	uetus	ADJqua	MascFem
et	et	CONcoo	_
diu	diu	ADV	_
notam	notus	ADJqua	Fem
serratos	serratus	ADJqua	Masc
bigatos	bigatus	ADJqua	Masc
-que	que	CONcoo	_

cetera	cetera	NOM	_
iam	iam	ADV	_
fabulosa	fabulosus	ADJqua	Neut
Hellusios	hellusii	NOM	_
et	et	CONcoo	_
Oxionas	oxionae	NOM	_
ora	os	NOM	_
hominum	homo	NOM	_
uultus	uultus	NOM	_
-que	que	CONcoo	_
corpora	corpus	NOM	_
atque	atque	CONcoo	_
artus	artus	NOM	_
ferarum	fera	NOM	_
gerere	gero	VER	_
quod	qui	PROrel	Neut
ego	ego	PROper	_
ut	ut	ADVrel	_
incompertum	incompertus	ADJqua	MascNeut
in	in	PRE	_
medium	medium	NOM	_
relinquam	relinquo	VER	_

est	sum	VER	_
in	in	PRE	_
eodem	idem	PROdem	MascNeut
obsequio	obsequium	NOM	_
et	et	ADV	_
Mattiacorum	mattiaci	NOM	_
gens	gens	NOM	_
protulit	profero	VER	_
enim	enim	CONcoo	_
magnitudo	magnitudo	NOM	_
populi	populus	NOM	_
Romani	romanus	ADJqua	MascNeut
ultra	ultra	PRE	_
Rhenum	rhenus	NOM	_
ultra	ultra	PRE	_
-que	que	CONcoo	_
ueteres	uetus	ADJqua	MascFem
terminos	terminus	NOM	_
imperii	imperium	NOM	_
reuerentiam	reuerentia	NOM	_

sed	sed	CONcoo	_
beatius	beatus	ADJqua	Neut
arbitrantur	arbitror	VER	_
quam	quam	ADVrel	_
ingemere	ingemo	VER	_
agris	ager	NOM	_
illaborare	illaboro	VER	_
domibus	domus	NOM	_
suas	suus	PROpos.ref	Fem
alienas	alienus	ADJqua	Fem
-que	que	CONcoo	_
fortunas	fortuna	NOM	_
spe	spes	NOM	_
metu	metus	NOM	_
-que	que	CONcoo	_
uersare	uerso	VER	_
securi	securus	ADJqua	Masc
aduersus	aduersus	PRE	_
homines	homo	NOM	_
securi	securus	ADJqua	Masc
aduersus	aduersus	PRE	_
deos	deus	NOM	_
rem	res	NOM	_
difficillimam	difficilis	ADJqua	Fem
assecuti	assequor	VER	Masc
ut	ut	CONsub	_
illis	ille	PROdem	Com
ne	ne	ADVneg	_
uoto	uotum	NOM	_
quidem	quidem	ADV	_
opus	opus	NOM	_
esset	sum	VER	_

intersunt	intersum	VER	_
parentes	parens	NOM	_
et	et	CONcoo	_
propinqui	propinquus	ADJqua	Masc
ac	ac	CONcoo	_
munera	munus	NOM	_
probant	probo	VER	_
munera	munus	NOM	_
non	non	ADVneg	_
ad	ad	PRE	_
delicias	delicia	NOM	_
muliebres	muliebris	ADJqua	MascFem
quaesita	quaero	VER	Neut
nec	nec	CONcoo	_
quibus	qui	PROrel	Com
noua	nouus	ADJqua	Fem
nupta	nupta	NOM	_
comatur	como	VER	_
sed	sed	CONcoo	_
boues	bos	NOM	_
et	et	CONcoo	_
frenatum	freno	VER	MascNeut
equum	equus	NOM	_
et	et	CONcoo	_
scutum	scutum	NOM	_
cum	cum	PRE	_
framea	framea	NOM	_
gladio	gladius	NOM	_
-que	que	CONcoo	_

nec	nec	CONcoo	_
enim	enim	CONcoo	_
cum	cum	PRE	_
ubertate	ubertas	NOM	_
et	et	CONcoo	_
amplitudine	amplitudo	NOM	_
soli	solum	NOM	_
labore	labor	NOM	_
contendunt	contendo	VER	_
ut	ut	CONsub	_
pomaria	pomarium	NOM	_
conserant	consero	VER	_
et	et	CONcoo	_
prata	pratum	NOM	_
separent	separo	VER	_
et	et	CONcoo	_
hortos	hortus	NOM	_
rigent	rigo	VER	_
sola	solus	PROind	Fem
terrae	terra	NOM	_
seges	seges	NOM	_
imperatur	impero	VER	_

definitur	definio	VER	_
et	et	ADV	_
numerus	numerus	NOM	_
centeni	centenus	ADJdis	Masc
ex	ex	PRE	_
singulis	singulus	ADJdis	Com
pagis	pagus	NOM	_
sunt	sum	VER	_
id	is	PROdem	Neut
-que	que	CONcoo	_
ipsum	ipse	PROdem	MascNeut
inter	inter	PRE	_
suos	sui	PROpos.ref	Masc
uocantur	uoco	VER	_
et	et	CONcoo	_
quod	qui	PROrel	Neut
primo	primo	ADJadv.ord	_
numerus	numerus	NOM	_
fuit	sum	VER	_
iam	iam	ADV	_
nomen	nomen	NOM	_
et	et	CONcoo	_
honor	honor	NOM	_
est	sum	VER	_

statim	statim	ADV	_
e	ex	PRE	_
somno	somnus	NOM	_
quem	qui	PROrel	Masc
plerumque	plerumque	ADV	_
in	in	PRE	_
diem	dies	NOM	_
extrahunt	extraho	VER	_
lauantur	lauo	VER	_
saepius	saepe	ADV	_
calida	calidus	ADJqua	Fem
ut	ut	ADVrel	_
apud	apud	PRE	_
quos	qui	PROrel	Masc
plurimum	multum	ADV	_
hiems	hiems	NOM	_
occupat	occupo	VER	_

